2019冠状病毒病	COVID-19
21三体综合症	trisomy
996	9am–9pm
A片	pornography
BP机	pager
C位	neologism
G弦裤	G-string
G点	G-spot
O型腿	bow-leggedness
T台	catwalk
T型台	catwalk
T恤	T-shirt
T裇	T-shirt
U型池	half-pipe
U形转弯	U-turn
X光	X-ray
coser	cosplayer
ins	Instagram
□	uptight
〇	zero
㑇	clever
𪢌哰	incoherent
㛂	graceful
㞗	dick
㥏	ashamed
㥯	cautious
㹴犬	terrier
䍃	pitcher
𫔆	plow
鳚	blenny
一不小心	accidentally
一些	some
一代	generation
一来	firstly
一侧化	lateralization
一元	univariate
一元论	monism
一共	altogether
一再	repeatedly
一动不动	motionless
一匙	spoonful
一半	half
一半天	soon
一同	together
一味	persistently
一团火	fireball
一堆	pile
一场空	futile
一尘不染	incorruptible
一壁	simultaneously
一夕	overnight
一夫一妻	monogamy
一夫多妻	polygamy
一妻制	monogamy
一字不差	verbatim
一字巾	headband
一定要	must
一对	couple
一对一	one-to-one
一层	layer
一己	oneself
一带	region
一打	dozen
一排	row
一本正经	deadpan
一准	certainly
一秉虔诚	devoutly
一等一	first-rate
一节诗	stanza
一线微光	gleam
一致性	consistency
一览表	table
一贫如洗	penniless
一过性	transient
一道	together
一钱如命	penny-pinching
一长一短	long-winded
丁丁	Tintin
丁内酯	butyrolactone
丁加奴	Terengganu
丁字	T-shaped
丁字梁	T-girder
丁字街	T-junction
丁烷	butane
丁鲷	tench
七国集团	G7
七大工业国集团	G7
七日热	leptospirosis
七旬老人	septuagenarian
七月份	July
七角形	heptagon
七边形	heptagon
七项全能	heptathlon
丈夫	husband
丈母	mother-in-law
丈母娘	mother-in-law
三倍	triple
三价	trivalent
三叉戟	trident
三味线	shamisen
三弦	sanxian
三得利	Suntory
三月份	March
三朋四友	friends
三板	sampan
三氯蔗糖	sucralose
三洋	Sanyō
三用电表	multimeter
三田	Mita
三秒胶	superglue
三联管	triplet
三胞胎	triplets
三色堇	pansy
三色紫罗兰	pansy
三菱	Mitsubishi
三叶虫	trilobite
三藏	Tripitaka
三角	triangle
三角学	trigonometry
三角形	triangle
三角旗	pennant
三角龙	triceratops
三资企业	foreign
三边形	triangle
三部曲	trilogy
三酸甘油酯	triglyceride
三重	treble
三阿姨	auntie
三只手	pickpocket
三项全能	triathlon
三驾马车	troika
三体	trisomy
上半天	morning
上品	top-quality
上层建筑	superstructure
上帝	God
上标	superscript
上网本	netbook
上艾瑟尔	Overijssel
上苍	heaven
上衫	blouse
上进心	ambition
上都	Shangdu
上颔	mandible
上龙	pliosaurus
下一次	next
下列	following
下半天	afternoon
下坡	downhill
下巴	chin
下巴颏	chin
下旋削球	golf
下槛	doorsill
下水管	drainpipe
下水道	sewer
下画线	underline
下关市	Shimonoseki
下颔	mandible
下风方向	leeward
不一会	soon
不三不四	shady
不丹	Bhutan
不人道	inhuman
不来梅港	Bremerhaven
不值得	unworthy
不偏不倚	impartial
不停	incessant
不备	unprepared
不免	inevitably
不兼容性	incompatibility
不凡	extraordinary
不分情由	indiscriminate
不加区别	indiscriminate
不加拘束	unrestricted
不加掩饰	undisguised
不加选择	indiscriminate
不动	motionless
不动摇	unmoved
不受欢迎	unwelcome
不可	cannot
不可侵犯权	inviolability
不可分离	inseparable
不可少	indispensable
不可思议	unimaginable
不可挽回	irreversible
不可收拾	unmanageable
不可数	uncountable
不可理喻	unreasonable
不可知论	agnosticism
不可磨灭	indelible
不可缺少	indispensable
不可置信	unbelievable
不可逆	irreversible
不可逆转	irreversible
不可避	unavoidable
不可避免	unavoidably
不可靠	unreliable
不合作	noncooperation
不合法	illegal
不合理	unreasonable
不吉利	ominous
不吐气	unaspirated
不周延	undistributed
不堪忍受	unbearable
不妥协	uncompromising
不孝	unfilial
不完善	imperfect
不定词	infinitive
不容置疑	unquestionable
不实	untruthful
不已	incessantly
不带电	uncharged
不平衡	disequilibrium
不幸之事	mishap
不必要	needless
不恭	disrespectful
不情愿	unwilling
不想	unexpectedly
不慌不忙	unhurried
不拉叽	nasty
不明不白	dubious
不是	fault
不智	unwise
不朽	eternal
不正常	abnormal
不比	unlike
不毛	barren
不毛之地	desert
不法分子	criminal
不清	unclear
不凑巧	unluckily
不准确	imprecise
不溶	insoluble
不满意	dissatisfied
不由自主	involuntarily
不当	unsuitable
不相容	incompatible
不知不觉	unwittingly
不知何故	somehow
不确实	untrue
不稳性	instability
不结盟	nonalignment
不经意	carelessly
不紧不慢	unhurried
不义	injustice
不声不响	silent
不育性	sterility
不自然	unnatural
不舒适	uncomfortable
不要	don't!
不要脸	shameless
不规则	irregular
不觉	unconsciously
不触目	unobtrusive
不言自明	self-evident
不说自明	obvious
不调和	discord
不识字	illiterate
不豫	displeased
不轨	errant
不近人情	unreasonable
不送气	unaspirated
不透明	opaque
不透气	airtight
不逞之徒	desperado
不连续	discontinuous
不道德	immoral
不长进	backward
不愿	unwilling
不食人间烟火	otherworldly
不饱和	unsaturated
且说	thus
丕	grand
世人	everyone
世仇	feud
世爵	Spyker
世界级	world-class
世界语	Esperanto
丘比特	Cupid
丘疹	pimple
丘脑	thalamus
丘陵	hills
丙烯腈	acrylo-nitrile
丙烷	propane
丞	deputy
并且	and
中介所	agency
中介资料	metadata
中位数	median
中低端	mid-to-low-range
中俄	China-Russia
中南半岛	Indochina
中南海	Zhongnanhai
中印	China-India
中印半岛	Indochina
中和剂	neutralizer
中国	China
中国中心主义	Sinocentrism
中国城	Chinatown
中国海洋石油总公司	CNOOC
中国红	vermilion
中土	Sino-Turkish
中子	neutron
中尼	China-Nepal
中层	middle-ranking
中巴	minibus
中巴士	minibus
中庭	courtyard
中式英语	Chinglish
中径	diameter
中心	center
中心粒	centriole
中性	neutral
中意	Sino-Italian
中提琴	viola
中文标准交换码	CSIC
中板	moderato
中欧	Sino-European
中法	China-France
中波	Chinese-Polish
中流	midstream
中程	medium-range
中等	medium
中篇小说	novella
中继器	repeater
中继资料	metadata
中美	China-USA
中肯	pertinent
中华龙鸟	Sinosauropteryx
中号	medium-sized
中西部	midwest
中转站	interchange
中途	midway
中都	Zhongdu
中间件	middleware
中间神经元	interneuron
中青年	middle-aged
中饭	lunch
串串狗	mutt
串串猫	moggy
丳	skewer
丸剂	pill
丹佛	Denver
丹尼索瓦人	Denisovan
丹砂	cinnabar
丹青	painting
丹魄	amber
丹麦	Denmark
主修	major
主力舰	battleship
主嫌	prime
主宰者	ruler
主导性	leadership
主席团	presidium
主教	bishop
主教座堂	cathedral
主机板	motherboard
主权	sovereignty
主犯	culprit
主管人员	executive
主裁判	umpire
主要	main
主观	subjective
主观主义	subjectivism
主词	subject
乀	stretch
幺点	ace
之上	above
之内	inside
之字形	Z-shaped
之至	extremely
乍得	Chad
乍浦	Zhapu
乏味	tedious
乘客	passenger
乘数	multiplier
乘法	multiplication
乙种	beta-
乙醇	ethanol
九十	ninety
九层塔	basil
九旬老人	nonagenarian
九边形	nonagon
乞丐	beggar
乞人	beggar
乞儿	beggar
也就是	i.e.
也许	perhaps
也门	Yemen
乳光	mineralogy
乳剂	emulsion
乳化剂	emulsifier
乳房摄影	mammography
乳果糖	lactulose
乳杆菌	lactobacillus
乳清	whey
乳白天空	whiteout
乳糖	lactose
乳罩	bra
乳腺炎	mastitis
乳胶	latex
乳贴	pasties
乳部	breasts
乳酪	cheese
乳酪蛋糕	cheesecake
乳头	nipple
乳头瘤	papilloma
乳香	frankincense
干枯	withered
干梅子	prunes
干燥剂	desiccant
干癣	psoriasis
干草	hay
干贝	conpoy
干酪	cheese
干酪素	casein
乱七八糟	muddled
乱局	turmoil
乱掉	chaotic
乱民	rebels
亄	covetous
了然	evident
事事	everything
事件	incident
事典	encyclopedia
事务所	firm
事证	evidence
二来	secondly
二元论	dualism
二十	twenty
二十面体	icosahedron
二𫫇英	dioxin
二尕子	scoundrel
二恶英	dioxin
二月份	February
二极管	diode
二氧化物	dioxide
二氧芑	dioxin
二氧杂芑	dioxin
二氯甲烷	dichloromethane
二甲苯	xylene
二硫基丙醇	dimercaprol
二糖	disaccharide
二级士官	sergeant
二维	two-dimensional
二苯氯胂	diphenylchloroarsine
二郎神	Erlangshen
二醇	glycol
二重唱	duet
二重母音	diphthong
二阿姨	auntie
互	mutual
互不侵犯	non-aggression
互操性	interoperability
互相依存	interdependent
互相连接	interlinked
互联	interconnected
互联网	Internet
互联网络	network
互连	interconnection
五光十色	dazzling
五十	fifty
五十铃	Isuzu
五彩纸屑	confetti
五旬节	Pentecost
五月份	May
五棱镜	pentaprism
五芒星	pentagram
五角	pentagon
五角形	pentagon
五角星	pentagram
五边形	pentagon
五项全能	pentathlon
井字棋	tic-tac-toe
井然	tidy
亚丁	Aden
亚利桑那	Arizona
亚利桑那州	Arizona
亚原子	subatomic
亚单位	subunit
亚太	Asia-Pacific
亚急性	subacute
亚拉巴马	Alabama
亚拉巴马州	Alabama
亚文化	subculture
亚松森	Asunción
亚格门农	Agamemnon
亚历山大里亚	Alexandria
亚比利尼	Abilene
亚特兰大	Atlanta
亚当	Adam
亚当斯	Adams
亚当斯敦	Adamstown
亚砷	arsenous
亚硝胺	nitrosamine
亚硝酸盐	nitrite
亚细亚	Asia
亚细安	Singapore
亚美利加	America
亚美尼亚	Armenia
亚临界	subcritical
亚该亚	Achaia
亚达薛西	Artaxerxes
亚铁	ferrous
亚非拉	Asia
亚马孙	Amazon
亚马逊	Amazon
亚麻	flax
亚麻仁	flaxseed
亚麻布	linen
亚麻籽	flaxseed
亟	anxiously
交叉感染	cross-infection
交叉火力	crossfire
交叉耐药性	cross-tolerance
交契	friendship
交易者	dealer
交响	symphony
交响曲	symphony
交响乐	symphony
亦	also
亦或	or
亨格洛	Hengelo
享乐主义	hedonism
享乐主义者	hedonist
京哈	Beijing-Harbin
京东	Jingdong
京都	Kyoto
亭子	pavilion
亭台	pavilion
亭阁	pavilion
亮度	brightness
亮闪闪	bright
亮饰	diamanté
亶	sincere
亹	resolute
人们	people
人儿	figurine
人力车	rickshaw
人参	ginseng
人口学	demography
人口数	population
人口普查	census
人口稠密	populous
人口调查	census
人孔	manhole
人字形	V-shape
人工流产	abortion
人师	mentor
人心果	sapodilla
人文主义	humanism
人文学	humanities
人族	Hominini
人望	prestige
人烟稀少	desolate
人物描写	portrayal
人畜共患症	zoonosis
人尽可夫	loose
人相	physiognomy
人群	crowd
人脉	contacts
人行横道	crosswalk
人行道	sidewalk
人质	hostage
人造奶油	margarine
人造牛油	margarine
人造丝	rayon
人造黄油	margarine
人头狮身	sphinx
人类学	anthropology
人类学家	anthropologist
人体工学	ergonomics
什	what
什一奉献	tithing
什刹海	Shichahai
什么时候	when?
仇外心理	xenophobia
仇敌	enemy
今日	today
今日头条	Toutiao
今晚	tonight
介系词	preposition
介绍信	reference
介胄	armor
介词	preposition
仍然	still
仔猪	piglet
仔鸡	chick
他们	they
他性	otherness
他者性	otherness
仗火	battle
付讫	paid
仙	immortal
仙人掌	cactus
仙台	Sendai
仙女	fairy
仙子	fairy
代利斯	Dallys
代数	algebra
代尔夫特	Delft
代理人	agent
代理商	agent
代码	code
代罪羔羊	scapegoat
代表队	delegation
代言人	spokesperson
代词	pronoun
代金券	voucher
令人钦佩	admirable
令人发指	abhorrent
令状	writ
以人为本	people-oriented
以及	and
以埃	Israel-Egypt
以太坊	Ethereum
以太网	Ethernet
以太网络	Ethernet
以巴	Israeli-Palestinian
以弗所	Ephesus
以往	formerly
以叙	Israel-Syria
以色列	Israel
以马内利	Emanuel
仰泳	backstroke
仲介	agent
仲裁	arbitration
仵工	pallbearer
价	servant
任何	any
任天堂	Nintendo
仿生	bionic
仿讽	parody
企业家	entrepreneur
企求	desirous
企鹅	penguin
伊利埃斯库	Iliescu
伊利诺	Illinois
伊利诺伊	Illinois
伊利诺伊州	Illinois
伊利诺州	Illinois
伊势丹	Isetan
伊尼亚斯	Aeneas
伊尼伊德	Aeneid
伊戈尔	Igor
伊拉克	Iraq
伊斯坦布尔	Istanbul
伊斯兰	Islam
伊斯兰堡	Islamabad
伊斯兰教	Islam
伊斯兰马巴德	Islamabad
伊曼纽尔	Emanuel
伊朗	Iran
伊尔库茨克	Irkutsk
伊留申	Ilyushin
伊蚊	Aedes
伋	unreal
伏特计	voltmeter
伏羲	Fuxi
伏都教	Voodoo
休伊特	Hewitt
休士顿	Houston
休惜	recess
休战	armistice
休斯敦	Houston
休斯顿	Houston
伯克利	Berkeley
伯利兹	Belize
伯劳	shrike
伯恩茅斯	Bournemouth
伯明翰	Birmingham
伯尔尼	Bern
伯赛大	Bethsaida
估测	estimate
伴郎	groomsman
伶人	actress
伶俜	solitary
伸手派	freeloader
伸手牌	freeloader
伸缩喇叭	trombone
伸缩性	flexibility
似乎	seemingly
似雪	snowy
似鲴	Xenocyprioides
伽倻	Gaya
伽利略号	Galileo
但是	but
位元币	Bitcoin
位形	configuration
低三下四	servile
低俗化	vulgarization
低地	lowland
低平火山口	maar
低息	low-interest
低眉顺眼	docile
低洼	low-lying
低端	low-end
低等	inferior
低语	mutter
低音	bass
低音喇叭	woofer
低音大提琴	contrabass
低音炮	subwoofer
低音管	bassoon
低体温症	hypothermia
住友	Sumitomo
住址	address
住宅	residence
住房	housing
住处	residence
佐世保	Sasebo
佐治亚	Georgia
佐治亚州	Georgia
佐罗	Zorro
佑护	blessing
占领者	occupant
何人	who
何方	where?
何日	when?
何时	when
佛吉尼亚	Virginia
佛塔	pagoda
佛手瓜	choko
佛教	Buddhism
佛教徒	Buddhist
佛法僧目	Coraciiformes
佛罗伦萨	Florence
佛罗里达	Florida
佛罗里达州	Florida
佛蒙特	Vermont
佛蒙特州	Vermont
佛门	Buddhism
作件	workpiece
作物	crop
作者	author
作者权	copyright
作证能力	competence
作马	sawhorse
佝瞀	stupid
你好	hello
佣金	commission
佣钱	commission
佤	Wa
佤族	Wa
佧佤族	Wa
佩奇	Peppa
佳世客	JUSCO
佳绩	success
佳美	beautiful
佴	assistant
佸	meet
佺	immortal
佼	handsome
使人信服	convincing
使徒	apostle
来客	guest
来由	reason
来项	income
例外字	exceptions
侍女	maid
侍妾	concubine
侍从官	aide-de-camp
侍应生	waiter
侍卫官	guard
侏	dwarf
侗	ignorant
供品	offering
供应品	supplies
供应商	supplier
供应者	supplier
供物	offering
供述	confession
依地酸二钴	kelocyanor
依属	dependence
依序	sequentially
依撒意亚	Isaiah
依然	still
侯爵	marquis
侵害人	perpetrator
侵权行为	tort
侵略者	aggressors
侵蚀作用	erosion
侣	companion
局	narrow
便利性	convenience
便士	penny
便宜	convenient
便帽	cap
便携式	portable
便民	user-friendly
便池	urinal
便车旅行者	hitch-hiker
俣	big
促狭鬼	rascal
促进	boost
俄中	Russia-China
俄中朝	Russia
俄亥俄	Ohio
俄亥俄州	Ohio
俄克拉何马	Oklahoma
俄克拉何马州	Oklahoma
俄勒冈	Oregon
俄勒冈州	Oregon
俄国	Russia
俄乌	Russo-Ukrainian
俄狄浦斯	Oedipus
俄罗斯	Russia
俊雅	graceful
俏美	charming
俘虏	captive
俚语	slang
保人	guarantor
保力龙	polystyrene
保加利亚	Bulgaria
保守主义	conservatism
保安族	Bao'an
保密性	secrecy
保温瓶	thermos
保洁	sanitation
保洁箱	litter-bin
保皇党	royalists
保真度	fidelity
保管箱	safe
保罗	Paul
保护主义	protectionism
保护国	protectorate
保护性	protective
保护者	protector
保镖	bodyguard
保障监督	safeguards
保险人	insurer
保险箱	safe
保丽龙	styrofoam
侠士	knight-errant
侠气	chivalry
信仰者	believer
信差	messenger
信徒	believer
信息图	infographic
信息图形	infographic
信息技术	IT
信息素	pheromone
信札	letter
信物	keepsake
信号	signal
信靠	trust
修手	manicure
修指甲	manicure
修正主义	revisionism
修脚	pedicure
修脚师	pedicurist
修补匠	tinker
修辞	rhetoric
修辞学	rhetoric
修道士	friar
俯卧撑	push-up
俳句	haiku
俸	stipend
俸钱	salary
俾格米	Pygmy
仓鼠	hamster
个人主义	individualism
个人电脑	PC
个体	individual
倍儿	really
倍增器	multiplier
倒位	inversion
倒着	backwards
倒角	chamfer
倔	gruff
倔强	stubborn
幸存者	survivor
倘	if
倘如	if
倘或	if
倘若	if
借代	metonymy
借译词	calque
倡言者	proposer
倢	handsome
倦	tired
倨	arrogant
倨傲	arrogant
伦敦	London
伦理	ethics
伦理学	ethics
假	vacation
假如	if
假小子	tomboy
假性	pseudo-
假性近视	pseudomyopia
假惺惺	phony
假掰	pretentious
假期	vacation
假球	match-fixing
假而	if
假设性	hypothetical
假设语气	subjunctive
假说	hypothesis
假象牙	celluloid
假释	parole
假面	mask
假体	implant
假发	wig
伟大	huge
伟晶岩	pegmatite
偏执狂	paranoia
偏瘫	hemiplegia
偏颇	biased
偏头痛	migraine
偏黄	yellowish
偓	constrained
做不到	impossible
停尸房	mortuary
停尸间	morgue
健力	powerlifting
健友	gym-goer
健忘	forgetful
健忘症	amnesia
健美运动	body-building
健身室	gym
健身房	gym
偨	uneven
侧记	sidelight
侦察性	investigatory
侦测器	detector
偶像	idol
偶合	coincidence
偷偷摸摸	sneaky
偷子	thief
偷摸	surreptitious
偷猎者	poacher
伪代码	pseudocode
伪君子	hypocrite
伪善	hypocritical
伪善者	hypocrite
伪科学	pseudoscience
伪纪录片	mockumentary
伪证	perjury
伪造者	forger
傍柳随花	prostitute
傍黑	dusk
杰作	masterpiece
杰士派	Gatsby
杰米	Jim
傔	servant
伞兵	paratrooper
伞形	umbrella-shaped
伞菌	agaric
备份	backup
备用二级头呼吸器	octopus
催乳激素	prolactin
催化作用	catalysis
催化剂	catalyst
催泪剂	lachrymator
催生素	oxytocin
催产素	oxytocin
催眠	hypnosis
催眠曲	lullaby
催眠状态	hypnosis
佣人	servant
傮	finish
傲慢无礼	disrespectful
传呼机	pager
传单	leaflet
传媒	media
传心术	telepathy
传感器	sensor
传教士	missionary
传染病学	epidemiology
传真电报	phototelegram
传闻	rumor
传声器	microphone
传道部	mission
传递者	messenger
伛	hunchbacked
债主	creditor
债务人	debtor
债户	debtor
债权人	creditor
债款	debt
伤寒	typhoid
伤寒症	typhoid
傻	foolish
傻不愣登	stupid
傻愣愣	petrified
傻瓜式	foolproof
傻眼	dumbfounded
傻头傻脑	muddle-headed
倾听者	listener
偻	hunchback
偻	crookbacked
佥	all
働	work
僎	collect
像片	photo
像素	pixel
像话	proper
侨民	expatriates
仆	servant
仆人	servant
仆役	servant
僧人	monk
僧侣	monk
僯	ashamed
僵住症	catalepsy
僵固性	rigidity
僵硬	stiff
价款	cost
价钱	price
仪典	ceremony
仪器表	gauge
仪容	appearance
仪式	ceremony
亿万富豪	multimillionaire
儅	stop
侩	broker
俭	thrifty
俭省	thrifty
俭约	frugal
俭腹	ignorant
俭薄	meager
儋	carry
儒学	Confucianism
儒教	Confucianism
儒艮	dugong
儓	servant
优胜	superior
优厚	generous
优惠券	coupon
优步	Uber
优生学	eugenics
优异	exceptional
优秀	outstanding
优衣库	Uniqlo
优游自得	unfettered
优酷	Youku
储物柜	locker
兀自	yet
元器件	component
元帅	commander-in-chief
元数据	metadata
元气	vigor
元组	tuple
元认知	metacognition
元语言	metalanguage
元资料	metadata
元音	vowel
兄弟会	fraternity
充沛	abundant
充满阳光	sun-drenched
兆瓦	megawatt
兆瓦时	megawatt-hour
兆瓦特	megawatt
兆赫	megahertz
凶犯	murderer
凶神	demon
凶神恶煞	devils
凶身	murderer
先例	precedent
先兆	omen
先前	before
先天性	congenital
先有	prior
先民	forebears
先决	prerequisite
先决条件	precondition
先河	source
先烈	martyr
先秦	pre-Qin
先声	herald
先行者	forerunner
先见	foresight
先见之明	foresight
先进先出	computing
先锋	vanguard
先锋派	avant-garde
先锋队	vanguard
先驱者	pioneer
光亮	bright
光刻	photolithography
光化学	photochemistry
光合	photosynthesis
光合作用	photosynthesis
光学	optics
光学雷达	lidar
光年	light-year
光度	luminosity
光敏	photosensitive
光溜	smooth
光滑	glossy
光漆	enamel
光照	illumination
光环	halo
光磁	magneto-optical
光秃秃	bald
光能合成	photosynthesis
光艳	gorgeous
光芒万丈	splendor
光谱	spectrum
光谱仪	spectrometer
光谱图	spectrogram
光谱学	spectroscopy
光遗传学	optogenetics
光电	photoelectric
光电二极管	photodiode
光电子	photoelectron
光头党	skinheads
克什米尔	Kashmir
克仑特罗	clenbuterol
克俭	thrifty
克利夫兰	Cleveland
克孜尔尕哈	Kizilgaha
克拉斯诺亚尔斯克	Krasnoyarsk
克拉科夫	Krakow
克林霉素	clindamycin
克汀病	cretinism
克沙奇病毒	Coxsackievirus
克尔白	Ka'aba
克维拉	Kevlar
克罗地亚	Croatia
克苏鲁	Cthulhu
克虏伯	Krupp
克里特	Crete
克里特岛	Crete
克里米亚	Crimea
克雷伯氏菌属	Klebsiella
免息	interest-free
免疫力	immunity
免疫学	immunology
免疫法	immunization
免责条款	disclaimer
免责声明	disclaimer
免费软件	freeware
儿媳	daughter-in-law
儿媳妇	daughter-in-law
儿子	son
儿孙	descendant
儿时	childhood
儿科	pediatrics
儿童	child
儿马	stallion
兔	rabbit
兔斯基	Tuzki
兜帽	hood
入侵者	intruder
入围者	finalist
入微	thoroughgoing
入时	fashionable
入海口	estuary
内啡素	endorphin
内啡肽	endorphin
内存储器	RAM
内布拉斯加	Nebraska
内布拉斯加州	Nebraska
内建	built-in
内涵意义	connotation
内源	source
内涝	waterlogged
内燃机车	automobile
内窥镜	endoscope
内置	built-in
内罗毕	Nairobi
内联网	intranet
内臣	chamberlain
内华达	Nevada
内华达州	Nevada
内衣裤	underwear
内视镜	endoscope
内部网	intranet
内酯	lactone
内陆	inland
全副	completely
全同	identical
全国性	national
全场一致	unanimous
全天候	all-weather
全局性	global
全心全意	wholeheartedly
全息	holographic
全情	wholeheartedly
全栈	full-stack
全民公决	referendum
全然	completely
全球化	globalization
全球而言	globally
全知	omniscient
全素	vegan
全素食	vegan
全般	entire
全部	whole
全体人员	crew
两国之间	bilateral
两岸三地	China
两星期	fortnight
两极分化	polarization
两样	different
两河流域	Mesopotamia
两用	dual-use
两节棍	nunchaku
两重	dual
八	eight
八倍体	octoploid
八字脚	splayfoot
八带鱼	octopus
八度	octave
八廓	Barkhor
八强赛	quarterfinals
八月份	August
八爪鱼	octopus
八角形	octagon
八角枫	alangium
八进制	octal
八达岭	Badaling
八边形	octagon
八开	octavo
八面体	octahedron
公丈	decameter
公主	princess
公允	equitable
公克	gram
公两	hectogram
公共	public
公共设施	infrastructure
公升	liter
公司行号	businesses
公合	deciliter
公寸	decimeter
公式	formula
公引	hectometer
公德心	civility
公撮	milliliter
公斗	decaliter
公会	guild
公正	just
公毫	centigram
公民	citizen
公爵夫人	duchess
公牛	bull
公众	public
公社	commune
公秉	kiloliter
公称	nominal
公义	righteousness
公猪	boar
公办	state-run
公里	kilometer
公厘	millimeter
公钱	decagram
公鸡	cock
公顷	hectare
六价	hexavalent
六分仪	sextant
六方	hexagonal
六月份	June
六芒星	hexagram
六角	hexagon
六角形	hexagon
六角星	hexagram
六边形	hexagon
六面体	hexahedron
共享软体	shareware
共同社	Kyōdō
共同体	community
共和制	republic
共和国	republic
共形	conformal
共时	synchronic
共济会	Freemasonry
共犯	accomplice
共生	symbiosis
共产主义	communism
共谋罪	conspiracy
共谋者	conspirator
共轭	math.
兵棋推演	war-gaming
兵舰	warship
兵队	troops
其实	actually
具体	concrete
典狱长	warden
典礼	ceremony
典雅	refined
兼容	compatible
兼容性	compatibility
册历	diary
再一次	again
再不	alternatively
再不然	otherwise
再处理	reprocessing
冒犯者	offender
冒纳罗亚	Moanalua
冒险家	adventurer
冒险者	adventurer
冗繁	miscellaneous
冗赘	verbose
冗长辩论	filibuster
冞	deep
冠状病毒	coronavirus
冠军	champion
冠军赛	championship
冤假错案	unjust
冤狱	frame-up
冤种	dupe
冬	winter
冬季	winter
冬蛰	hibernation
冬青	holly
冬青树	holly
冰上运动	ice-sports
冰冷	ice-cold
冰凌	icicle
冰凝器	cryophorus
冰塔	serac
冰屋	igloo
冰岛	Iceland
冰川	glacier
冰帽	icecap
冰晶石	cryolite
冰柱	icicle
冰柜	freezer
冰毒	methamphetamine
冰河	glacier
冰凉	ice-cold
冰溜	icicle
冰沟	crevasse
冰爪	crampon
冰片	borneol
冰窖	icehouse
冰锥	icicle
冰镇	iced
冰隙	crevasse
冶天	ATI
冶金	metallurgy
冶金学	metallurgy
冷	cold
冷冷	coldly
冷冽	chilly
冷冻柜	freezer
冷却剂	coolant
冷厉	stern
冷媒	refrigerant
冷水机组	chiller
冷清	desolate
冷热病	malaria
冷知识	trivia
冷轧	cold-rolling
冷酷	unfeeling
冷酷无情	cold-hearted
冷飕飕	chilling
准将	commodore
凇	icicle
凊	cool
凋	withered
凌乱	messy
凌志	Lexus
凌云	lofty
冻伤	frostbite
冻原	tundra
冻胶	gel
凔	cold
凝固汽油弹	napalm
凝液	condensate
凝胶	gel
凝胶体	gel
凝花菜	gelidiella
凝血酶原	prothrombin
凡事	everything
凡是	every
凯夫拉	Kevlar
凯尼恩	Canyon
凯歌	paean
凯法劳尼亚	Kefalonia
凯尔特人	Celt
凯芙拉	Kevlar
凯迪拉克	Cadillac
凯达格兰	Ketagalan
凯达格兰族	Ketagalan
凵	receptacle
凶暴	brutal
凶残	savage
凸度	convexity
凸性	convexity
凸缘	flange
凸轮	cam
凸轮轴	camshaft
凹	concave
凹凸形	crenelated
凹凸有致	curvaceous
凹凸轧花	embossing
凹度	concavity
凹线	groove
凹陷	hollow
出乎意外	unexpected
出乎预料	unexpected
出人意外	unexpected
出入口	gateway
出家人	monk
出席者	attendee
出版商	publisher
出版物	publications
出版者	publisher
出生地	birthplace
出色	remarkable
出血性	hemorrhagic
凼肥	manure
刀光血影	massacre
刀剑	sword
刀斧手	lictor
刀叶	blade
刀鞘	scabbard
分布式	distributed
分光光度法	spectrophotometry
分光计	spectrometer
分克	decigram
分册	fascicle
分升	deciliter
分局	sub-bureau
分属	classification
分岔	bifurcation
分形	fractal
分散式	distributed
分会	branch
分会场	sub-venues
分析器	analyzer
分枝	branch
分桃	homosexual
分水线	watershed
分泌物	secretion
分瓦	deciwatt
分生组织	meristem
分站	substation
分节	segmented
分米	decimeter
分系统	subsystem
分裂主义	separatism
分解作用	decomposition
分贝	decibel
分销商	distributor
分镜	storyboard
分镜表	storyboard
分镜头	storyboard
分钟	minute
分离主义	separatism
分离分子	separatist
切分音	syncopation
切实可行	feasible
切尔诺贝利	Chernobyl
切结书	affidavit
切迫	urgent
切韵	Qieyun
刈	mow
刊物	publication
刑事	criminal
列克星顿	Lexington
列宁主义	Leninism
列支敦士登	Liechtenstein
初潮	menarche
判断语	predicate
别人	others
别克	Buick
别致	unusual
别庄	villa
别处	elsewhere
别号	alias
刨子	plane
刨齿	gear-shaping
利他主义	altruism
利伯曼	Liberman
利伯维尔	Libreville
利古里亚	Liguria
利奈唑胺	Linezolid
利尿剂	diuretic
利己主义	egoism
利欲	cupidity
利欲心	cupidity
利比亚	Libya
利比里亚	Liberia
利润	profits
利索	nimble
利兹	Leeds
利宾纳	Ribena
利隆圭	Lilongwe
利雅得	Riyadh
利雅德	Riyadh
利马	Lima
利默里克	Limerick
刮铲	scraper
刮胡刀	razor
到岸价	cost
到处	everywhere
制动器	brake
制度化	systematization
制式化	standardization
刺儿李	gooseberry
刺刀	bayonet
刺客	assassin
刺激物	stimulus
刺绣品	embroidery
刺耳	ear-piercing
刺猬	hedgehog
刺身	sashimi
刻板印象	stereotype
刻痕	notch
剃刀	razor
前例	precedent
前备箱	frunk
前传	prequel
前凸后翘	buxom
前列腺	prostate
前列腺炎	prostatitis
前列腺素	prostaglandin
前哨战	skirmish
前因	antecedents
前大灯	headlight
前女友	ex-girlfriend
前寒武纪	pre-Cambrian
前戏	foreplay
前所未闻	unprecedented
前提条件	preconditions
前桅	foremast
前段时间	recently
前灯	headlight
前男友	ex-boyfriend
前置词	preposition
前腿	forelegs
前臂	forearm
前菜	appetizer
前额	forehead
前体	chemistry
剖腹自杀	hara-kiri
刚度	stiffness
刚强	firm
刚性	rigidity
刚毛	bristle
剡	sharp
剪草机	lawnmower
剪贴簿	scrapbook
副主席	vice-chairperson
副刊	supplement
副官	aide-de-camp
副手	assistant
副校长	vice-principal
副业	sideline
副标题	subheading
副产品	by-product
副秘书长	vice-secretary
副总统	vice-president
副词	adverb
副议长	vice-chairman
副驾驶员	copilot
副黏液病毒	paramyxovirus
创世论	creationism
创作力	originality
创作者	creator
创伤	wound
创伤后压力症候群	PTSD
创伤后应激障碍	PTSD
创口	wound
创口贴	band-aid
创可贴	band-aid
创始人	creator
创始者	creator
创建者	founder
创新精神	creativity
创业者	entrepreneur
创立人	founder
创立者	founder
创办者	founder
创造者	creator
剸	slash
剺	mark
划时代	epoch-marking
剧作家	playwright
剧本	script
剧烈	violent
剧集	series
劈离	split
剑客	swordsman
剑桥	Cambridge
剑术	swordsmanship
剑鱼	swordfish
剑龙	stegosaurus
劘	whittle
力波	Reeb
力矩	torque
力量	power
功令	decree
功利	utility
功利主义	utilitarianism
功效	efficacy
功烈	achievement
功用	function
功能	function
功能性	functionality
加之	moreover
加利福尼亚	California
加利福尼亚大学洛杉矶分校	UCLA
加利福尼亚州	California
加利西亚	Galicia
加勒比	Caribbean
加国	Canada
加密货币	cryptocurrency
加宽	widen
加州	California
加德满都	Kathmandu
加拉加斯	Caracas
加拉巴哥斯	Galapagos
加拿大	Canada
加数	addend
加法	addition
加泰罗尼亚	Catalonia
加湿器	humidifier
加甜	sweeten
加的夫	Cardiff
加的斯	Cádiz
加纳	Ghana
加蓬	Gabon
加速度	acceleration
加里肋亚	Galilee
劣	inferior
劣等	poor-quality
劣质	shoddy
助手	assistant
助熔剂	flux
助理	assistant
助产士	midwife
助词	particle
努克	Nuuk
努库阿洛法	Nuku'alofa
努比亚	Nubia
努瓜娄发	Nuku'alofa
努瓦克肖特	Nouakchott
努美阿	Nouméa
劫难	calamity
劬	labor
劻	zealous
劲力	power
劲挺	strong
劲烈	violent
勃朗宁	Browning
勃兰登堡	Brandenburg
勇	brave
勇悍	brave
勇敢	brave
勇武	brave
勇气	courage
勒索罪	blackmail
动名词	gerund
动向	trend
动情激素	estrogen
动情素	estrogen
动态影像	video
动机	motive
动物性	animacy
动物毒素	zootoxin
动物淀粉	glycogen
动脉	artery
动脉瘤	aneurysm
动脉粥样硬化	atherosclerosis
动觉	kinesthesia
动词	verb
动量	momentum
动魄	shocking
勘误表	corrigenda
勋章	medal
胜任能力	competency
胜者	winner
劳动者	worker
劳务人员	laborer
劳拉西泮	lorazepam
劳斯莱斯	Rolls-Royce
势利	snobbish
势利小人	snob
势子	gesture
勤俭务实	hardworking
勤快	diligent
勯	exhausted
勰	harmonious
勋绩	exploit
勷	haste
勿忘我	forget-me-not
包价	package
包容心	tolerance
包心菜	cabbage
包柔氏螺旋体	Borrelia
包氏螺旋体	Borrelia
包皮环切	circumcision
包皮环切术	circumcision
包谷	maize
包粟	maize
包菜	cabbage
包袋	bag
包装物	packaging
匆匆	hurriedly
匆猝	hurried
匈奴	Xiongnu
匈牙利	Hungary
匋	pottery
匕首	dagger
化妆舞会	masquerade
化学信息素	semiochemical
化学品	chemicals
化学家	chemist
化学性	chemical
化学治疗	chemotherapy
化学物	chemicals
化学疗法	chemotherapy
化学需氧量	COD
化油器	carburetor
化疗	chemotherapy
化石	fossil
北佬	northerner
北圻	Tonkin
北山羊	ibex
北方工业	Norinco
北海道	Hokkaidō
北莱茵·威斯特法伦州	Nordrhein-Westfalen
北韩	Tw
匙	spoon
匠	craftsman
匣	box
匪徒集团	gangster
匪盗	bandit
匪首	bandit
汇划	remittance
汇寄	remit
汇金	finance
匮竭	exhausted
匹夫匹妇	commoners
匹马力	horsepower
匿名	anonymous
区域性	regional
区块	block
十一月份	November
十二指肠	duodenum
十二月份	December
十二角形	dodecagon
十二边形	dodecagon
十二面体	dodecahedron
十亿位元	gigabit
十克	decagram
十全	perfect
十六进制	hexadecimal
十四	fourteen
十四行诗	sonnet
十字架刑	crucifiction
十字丝	crosshairs
十字绣	cross-stitch
十字转门	turnstile
十字镐	pickaxe
十成	completely
十月份	October
十角形	decagon
十进制	decimal
十边形	decagon
十项全能	decathlon
千	thousand
千伏	kilovolt
千位元	kilobit
千克	kilogram
千分尺	micrometer
千吨	kiloton
千娇百媚	charming
千字节	kilobyte
千层面	lasagna
千年	millennium
千焦	kilojoule
千瓦时	kilowatt-hour
千米	kilometer
千赫	kilohertz
千足虫	millipede
千里眼	clairvoyance
卄	twenty
卅	thirty
升班马	sports
午夜	midnight
午后	afternoon
午餐会	luncheon
卉	plants
半乳糖血症	galactosemia
半信半疑	skeptical
半圆	semicircle
半圆仪	protractor
半圆形	semicircular
半大	medium-sized
半大不小	teenage
半官方	semiofficial
半封建	semifeudal
半导体	semiconductor
半岛	peninsula
半径	radius
半数	half
半文盲	semiliterate
半殖民地	semicolonial
半决赛	semifinals
半流体	semifluid
半无限	semi-infinite
半熟	half-cooked
半熟练	semiskilled
半球	hemisphere
半神	demigod
半空	midair
半腱肌	semitendinosus
半自动	semiautomatic
半裸	half-naked
半裸体	half-naked
半规则	quasi-regular
半开化	semicivilized
半开半关	half-open
半音	semitone
半音程	semitone
卌	forty
卍	swastika
卐	swastika
卑以自牧	modest
卑南族	puyuma
卑尔根	Bergen
卑鄙无耻	despicable
卓	outstanding
协和式客机	Concorde
协和飞机	Concorde
协奏曲	concerto
协处理器	coprocessor
协调人	coordinator
协调员	coordinator
南	south
南安普敦	Southampton
南岛民族	Austronesian
南希	Nancy
南方古猿	Australopithecus
南极洲	Antarctica
南瓜	pumpkin
南瓜灯	jack-o'-lantern
南诏国	Nanzhao
南赡部洲	Jambudvipa
南高加索	Transcaucasia
博主	blogger
博伊西	Boise
博士学位	PhD
博士后	postdoc
博大	broad
博学	learned
博客圈	blogosphere
博彩	gambling
博后	postdoc
博徒	gambler
博斯普鲁斯	Bosphorus
博格多	Bogdo
博洛尼亚	Bologna
博尔德	Boulder
博物院	museum
博物馆	museum
博福斯	Bofors
博茨瓦纳	Botswana
博蒙特	Beaumont
博雅	learned
博鳌镇	Bo'ao
卜筮	divination
卞	hurried
占婆	Champa
占星学	astrology
占星家	astrologer
占星师	astrologer
占星术	astrology
占比	proportion
卡丁车	go-kart
卡利亚里	Cagliari
卡利卡特	Calicut
卡利多尼亚	Caledonia
卡塔尼亚	Catania
卡塔尔	Qatar
卡塔赫纳	Cartagena
卡夫	Kraft
卡宴	Cayenne
卡尺	calipers
卡恩	Kahn
卡扣	clip
卡拉布里亚	Calabria
卡斯特利翁	Castellón
卡斯特里	Castries
卡斯翠	Castries
卡斯蒂利亚·莱昂	Castilla-Leon
卡洛驰	Crocs
卡尔加里	Calgary
卡尔顿	Carleton
卡片	card
卡美洛	Camelot
卡西欧	Casio
卡顿	unresponsive
卡骆驰	Crocs
卮	goblet
印刷者	printer
印古什	Ingushetia
印堂穴	yintang
印度	India
印度尼西亚	Indonesia
印度支那	Indochina
印度斯坦	Hindustan
印度音乐	Bhangra
印度－雅利安	Indo-Aryan
印痕	mark
印第安纳	Indiana
印第安纳州	Indiana
印第安纳波利斯	Indianapolis
印象主义	impressionism
印象派	impressionism
印迹	footprint
危地马拉	Guatemala
危害性	harmfulness
危性	risk
危难	calamity
即将	soon
即将来临	imminent
即插即用	plug-and-play
即时	immediate
即时即地	moment-to-moment
即由	namely
即兴之作	improvisation
即兴发挥	improvisation
卵子	ovum
卵巢	ovary
卵母细胞	ovocyte
卵石	cobble
卷帙	book
卷须	tendril
厄	distressed
厄娃	Eve
厄瓜多尔	Ecuador
厄立特里亚	Eritrea
厎	whetstone
厖	huge
厚度	thickness
厚颜	shameless
厚颜无耻	shameless
原函数	antiderivative
原则性	principled
原创力	creativity
原创性	originality
原子弹	A-bomb
原子笔	Tw
原居	indigenous
原木	logs
原核生物	prokaryote
原汁原味	original
原生质	protoplasm
原声带	soundtrack
原虫	protozoan
厪	hut
厌女症	misogyny
厌氧	anaerobic
厌烦	bored
厌食	anorexia
厌食症	anorexia
厉行	rigorously
厉鬼	devil
厹	spear
去中心化	decentralization
去向	whereabouts
去垢剂	detergent
去氧麻黄碱	methamphetamine
参加者	participant
参孙	Samson
参差	uneven
参数	parameter
参与者	participant
参访团	delegation
参议员	senator
参鸡汤	samgyetang
叉勺	spork
叉形	forked
友	friend
友人	friend
友善	friendly
反人类	inhuman
反例	counterexample
反倾销	anti-dumping
反共	anti-communist
反动分子	reactionaries
反动派	reactionaries
反叛分子	rebel
反坦克	anti-tank
反季	off-season
反季节	off-season
反安慰剂	nocebo
反射镜	reflector
反导	anti-missile
反导弹	anti-missile
反差	contrast
反应堆	reactor
反战	anti-war
反批评	countercriticism
反抗者	rebel
反散射	backscatter
反日	anti-Japan
反时势	unconventional
反时针	counterclockwise
反智	anti-intellectual
反智主义	anti-intellectualism
反智论	anti-intellectualism
反气旋	anticyclone
反乌托邦	dystopia
反照	reflection
反物质	antimatter
反犹太主义	antisemitism
反用换流器	inverter
反知识	anti-intellectual
反美	anti-American
反义词	antonym
反而	instead
反腐	anti-corruption
反舰艇	anti-ship
反刍动物	ruminant
反英	anti-English
反英雄	antihero
反华	anti-Chinese
反诉状	counterclaim
反语	irony
反贪污	anticorruption
反贪腐	anti-corruption
反转录病毒	retrovirus
反锯齿	anti-aliasing
反铲	backhoe
反革命	counterrevolutionary
反高潮	anticlimax
反党	anti-party
取款机	ATM
受害人	victim
受格	objective
受欢迎	popular
受益人	beneficiary
受看	good-looking
受穷	poor
受托者	trustee
受访者	interviewee
受难纪念	memorial
受惊	startled
叛国	treason
叛教	apostasy
叛逆者	traitor
口哨	whistle
口感	mouthfeel
口才	eloquence
口技表演者	ventriloquist
口水	saliva
口渴	thirsty
口琴	harmonica
口粮	ration
口红	lipstick
口角	altercation
口译	interpreting
口足目	Stomatopoda
口风琴	melodica
古人类学	paleoanthropology
古杰拉特邦	Gujarat
古典	classical
古典派	classicists
古吉拉特	Gujarat
古吉拉特邦	Gujarat
古地磁	paleomagnetism
古巴	Cuba
古文字学	paleography
古时	antiquity
古气候学	paleoclimatology
古物	antique
古生物	paleo-organism
古生物学	palaeontology
古生物学家	paleontologist
古旧	archaic
句法	syntax
另用	diversion
叨	garrulous
只	only
只要	provided
叫法	term
叫花子	beggar
召集人	convener
叭啦狗	bulldog
叮当声	tinkle
叮铃	jingle
可不是	indeed
可信	trustworthy
可信任	trusty
可伦坡	Colombo
可动	movable
可口	tasty
可口可乐	Coca-Cola
可吃	edible
可哀	miserably
可嘉	laudable
可回收	recyclable
可塑性	plasticity
可压缩	compressible
可容忍	tolerable
可尊敬	respectable
可就	certainly
可得到	available
可恃	reliable
可恨	hateful
可悲	lamentable
可恼	aggravating
可想像	conceivable
可虑	worrisome
可憎	disgusting
可懂度	intelligibility
可持续	sustainable
可接受性	acceptability
可控硅	thyristor
可擦写	erasable
可支付性	affordability
可敬	venerable
可望而不可及	unattainable
可乐饼	croquette
可比	comparable
可溶	soluble
可溶性	solubility
可燃	inflammable
可疑分子	suspect
可知论	gnosticism
可编程	programmable
可能性	possibility
可行	feasible
可行性	feasibility
可裂变	fissionable
可视化	visualization
可视电话	videophone
可调	adjustable
可读性	readability
可变	variable
可逆性	reversibility
可靠	reliable
可靠性	reliability
可食	edible
可惊	astonishing
台北	Taipei
台南	Tainan
台座	pedestal
台式	Taiwanese-style
台球	billiards
史册	annals
史学	historiography
史学家	historian
史家	historian
史蒂文	Steven
史诗性	epic
史诗级	epic
史诗般	epic
史高比耶	Skopje
右撇子	right-hander
右派分子	rightist
司令员	commander
司兼导	driver-guide
司导	driver-guide
司机	chauffeur
司法权	jurisdiction
司汤达	Stendhal
司祭	priest
司药	pharmacist
司铎	priest
叻沙	laksa
吃播	mukbang
各人	everyone
各种	various
各色各样	various
合乎情理	reasonable
合宜	appropriate
合得来	compatible
合情合理	fair
合宪性	constitutionality
合法性	legitimacy
合理	rational
合众银行	Bancorp
合股线	twine
合叶	hinge
合规	compliance
合该	should
合适	suitable
合金	alloy
合页	hinge
吉之岛	JUSCO
吉事果	churro
吉佳利	Kigali
吉利	Geely
吉卜赛人	Gypsy
吉布提	Djibouti
吉普赛人	Gypsy
吉尔吉斯坦	Kyrgyzstan
吉尔吉斯斯坦	Kyrgyzstan
吉祥物	mascot
吉米	Jimmy
吊儿郎当	sloppy
吊床	hammock
吊线	plumbline
吊绳	sling
同一	identical
同上	ditto
同事	colleague
同仁堂	Tongrentang
同伴	companion
同位	par
同位素	isotope
同僚	colleague
同型性	isomorphism
同型配子	isogamete
同性爱	homosexual
同性恋恐惧症	homophobia
同手同脚	clumsy
同时	simultaneously
同时代	contemporary
同案犯	accomplice
同步加速器	synchrotron
同源词	cognate
同犯	accomplice
同班同学	classmate
同理	Tongli
同理心	empathy
同盟	alliance
同素异形体	allotropy
同义	synonymous
同义反复	tautology
同义字	synonym
同义词	synonym
同义语	synonym
同胞兄妹	sibling
同质	homogeneous
同轴	coaxial
同配生殖	isogamy
同音词	homophone
同类相食	cannibalism
名古屋	Nagoya
名媛	debutante
名宿	luminary
名气	reputation
名义上	nominally
名声	reputation
名著	masterpiece
名录	directory
名头	reputation
后羿	Houyi
吐根	ipecac
吐瓦鲁	Tuvalu
吐绶鸡	turkey
向何处	whither
向南	southward
向外	outward
向后	backward
向性	tropism
向东	eastwards
向盘	compass
向西	westward
向西南	southwestward
向阳花	sunflower
君主制	monarchy
君主政治	monarchy
君士坦丁堡	Constantinople
吜	onom.
吝啬	stingy
吝啬鬼	miser
吞吐量	throughput
否则	otherwise
否决票	veto
吧女	barmaid
吪	move
含味隽永	fine
含情脉脉	tender-hearted
含意	meaning
含水	watery
含水层	aquifer
含片	lozenge
含碳	carbonic
吭	throat
吰	clang
吱	squeak
吱吱声	squeak
吴哥城	Ankorwat
吵杂	noisy
吵闹声	noise
吸入剂	inhalant
吸入器	inhaler
吸气器	aspirator
吸水	absorbent
吸湿性	absorbent
吸睛	eye-catching
吸积	accretion
吸铁石	magnet
吸门	epiglottis
吸附剂	absorbent
吸音	sound-absorbing
吹哨人	whistleblower
吹笛者	piper
吹管	blowpipe
吻部	snout
吼声	roar
吾	my
呀诺达	Yanoda
吕	pitchpipe
吕贝克	Lübeck
呆笨	dimwitted
呆头呆脑	oafish
呇	star
告示	announcement
告解	confession
呢呢痴痴	docile
呢喃细语	murmuring
呧	vex
周围	environs
周密	careful
周径	girth
周庄	Zhouzhuang
周庄镇	Zhouzhuang
周边商品	merch
味之素	Ajinomoto
味儿	taste
味醂	mirin
呵欠	yawn
呷呷	honk
呼叫器	pager
呼叫声	whoop
呼吸管	snorkel
呼呼声	whir
呼机	pager
命名法	nomenclature
命理学	divination
命相	horoscope
命脉	lifeline
咇	fragrant
咈	oppose
和合	harmony
和善	good-natured
和平主义	pacifism
和服	kimono
和洽	harmonious
和牛	wagyu
和田市	Hotan
咖啡师	barista
咚咚	Dongdong
咯	phonetic
咯吱	groan
咯咯笑	chuckle
咳	cough
咷	wail
咸兴	Hamhung
咸兴市	Hamhung
咹	eh?
咽喉	throat
咽炎	pharyngitis
咽头	pharynx
哀失	bereavement
哀家	I
哀艳	poignant
品目	item
品节	character
品红	magenta
品级	workmanship
品达	Pindar
哆啦A梦	Doraemon
哆啰美远	Torobiawan
哆啰美远族	Torobiawan
哈佛	Harvard
哈利	Harry
哈博罗内	Gaborone
哈啰出行	Hellobike
哈奴曼	Hanuman
哈巴罗夫斯克	Khabarovsk
哈得斯	Hades
哈德斯	Hades
哈恩	Jaén
哈拉雷	Harare
哈摩辣	Gomorrah
哈日	Japanophile
哈普西科德	harpsichord
哈根达斯	Häagen-Dazs
哈梅内伊	Khamenei
哈欠	yawn
哈特福德	Hartford
哈瓦那	Havana
哈罗德	Harold
哈萨克斯坦	Kazakhstan
哈迪斯	Hades
哈里斯堡	Harrisburg
哈里发国	caliphate
哈灵根	Harlingen
哈马黑拉岛	Halmahera
哐	bang
哐啷	clatter
员工	staff
员警	policeman
哤	jargon
哥利亚	Goliath
哥尼斯堡	Königsberg
哥斯拉	Godzilla
哥特式	gothic
哨兵	sentinel
哨子	whistle
哩	mile
哪一个	which
哪吒	Nezha
哮喘	asthma
哮喘病	asthma
哮鸣	wheezing
哲学	philosophy
哲学博士	PhD
哲学家	philosopher
哺乳动物	mammal
哺乳纲	Mammalia
哺乳类动物	mammals
哺母乳	breastfeeding
哼唧	whisper
哼声	hum
唇	lip
唇形科	Labiatae
唇齿	interdependent
唐狗	mongrel
唯	yes
唯一	only
唯一性	uniqueness
唯有	only
唯物	materialistic
唯物主义	materialism
唯美	aesthetics
唯象	phenomenological
唯象理论	phenomenology
唱名	solfege
唱机	gramophone
唱碟	LP
唱词	libretto
唱诗班	choir
唾沫星子	sputter
唾液	saliva
唿喇	whoosh
啄木鸟	woodpecker
啅	chirp
商品化	commodification
商民	merchant
商汤科技	SenseTime
商贾	merchant
商铺	shop
商队	caravan
啎	obstinate
问责性	accountability
哑剧	pantomime
启动子	promoter
启发式	heuristic
启示者	revelator
啤	beer
啤酒厂	brewery
啤酒花	hops
啦啦队长	cheerleader
喀土穆	Khartoum
喀山	Kazan
喀布尔	Kabul
喀尔喀	Khalkha
善哉	excellent
善感	sensitive
喇	phonetic
喇叭形	flared
喇叭水仙	daffodil
喇嘛	lama
喇沙	laksa
喉炎	laryngitis
喉镜	laryngoscope
喊话器	megaphone
喋血	carnage
喌	syllable
喑	mute
喜人	pleasing
喜喜欢欢	happily
喜孜孜	pleased
喜乐	joy
喜气洋洋	jubilation
喜兴	joyous
喜马拉雅山	Himalayas
喜马拉雅山脉	Himalayas
喦	talkative
丧尸	zombie
丧心病狂	demented
丧气	unlucky
丧礼	funeral
丧钟	knell
丧魂失魄	dazed
乔	tall
乔治亚州	Georgia
乔治敦	Georgetown
乔答摩	Gautama
单元房	apartment
单丛	Dancong
单向	unidirectional
单峰驼	dromedary
单方面	unilateral
单晶	monocrystalline
单核细胞增多症	mononucleosis
单簧管	clarinet
单糖	monosaccharide
单细胞	unicellular
单翼飞机	monoplane
单脚滑行车	scooter
单语	monolingual
单调	monotonous
单身汉	bachelor
单车族	cyclist
单轨	monorail
单轮车	unicycle
单边	unilateral
单边主义	unilateralism
单铬	monochrome
单项	single-item
嗄	hoarse
啬	stingy
嗒丧	disappointed
嗒然	depressed
嗓子眼	throat
嗓眼	throat
嗓门眼	throat
嗓音	voice
嗜好	hobby
嗜欲	lust
嗜杀成性	bloodthirsty
嗞啦	sizzle
嗡嗡	drone
嗯哼	uh-huh
哔	phonetic
𪡏	chattering
嘁嘁喳喳	chattering
嘉士伯	Carlsberg
嘉宝果	jaboticaba
嘉义	Chiayi
呕	vomit
呕出物	vomitus
呕吐物	vomit
叽	grumble
嘴巴子	slap
嘴牢	tight-lipped
嘴笨	inarticulate
嘴松	loose-tongued
嘶哑声	hoarse
嘿	hey
噔	thump
器具	implement
器官	apparatus
器量	tolerance
噩	startling
噩梦	nightmare
噪声	noise
噬菌体	bacteriophage
噭	shout
喷嚏	sneeze
喷嚏剂	sternutator
喷气式	jet-propelled
喷泉	fountain
喷洒器	sprinkler
喷火器	flamethrower
喷灯	blowtorch
喷雾器	sprayer
噶噶	onom.
噶玛兰族	Kavalan
吨位	tonnage
吨数	tonnage
当啷	clanging
嚅	chattering
哜	sip
嚏	sneeze
嚏喷	sneeze
啮齿动物	rodent
向导	guide
严密	tight
严重	grave
严重性	seriousness
嚼劲	chewiness
嚼劲儿	chewiness
嚼蜡	insipid
嚣	clamor
冁	smilingly
囊泡	vesicle
囊空如洗	broke
囊袋	pouch
啮齿类	rodents
囔	muttering
囗	enclosure
囚	prisoner
囚徒	prisoner
囚犯	prisoner
四下	everywhere
四分之一	one-quarter
四分五裂	scattered
四强赛	semifinals
四日市	Yokkaichi
四日市市	Yokkaichi
四月份	April
四氢大麻酚	Tetrahydrocannabinol
四氯乙烯	tetrachloroethylene
四环素	tetracycline
四脚蛇	lizard
四角形	quadrilateral
四轮马车	chariot
四近	nearby
四部曲	tetralogy
四面体	tetrahedron
囝	child
回单	receipt
回执单	receipt
回忆录	memoir
回教	Islam
回文	palindrome
回旋曲	rondo
回冲	backwash
回绕	winding
回声	echo
回声定位	echolocation
因努伊特	Inuit
因式分解	factorization
因斯布鲁克	Innsbruck
因此	thus
因特网	Internet
因纽特	Inuit
囫囵	whole
囮	decoy
困境	predicament
困窘	embarrassment
固体	solid
固体食物	solids
圈	pen
圈内人	insider
圈圈叉叉	tic-tac-toe
圈套	trap
圈状物	hoop
国内生产毛额	GDP
国君	monarch
国子监	Guozijian
国度	country
国会大厦	capitol
国有化	nationalization
国民生产毛额	GNP
国王	king
国籍	nationality
国美	GOME
国际	international
国际主义	internationalism
国际互联网络	Internet
国际文传电讯社	Interfax
围兜	bib
围产	perinatal
围篱	fence
围裙	apron
园丁	gardener
园囿	park
园林	gardens
园游会	carnival
圆周	circumference
圆圈	circle
圆屋顶	dome
圆形剧场	amphitheater
圆形木材	log
圆括号	parentheses
圆明园	Yuanmingyuan
圆柱形	cylindrical
圆滚滚	plump
圆满	satisfactory
圆珠	bead
圆盘	disk
圆舞曲	waltz
圆角	fillet
圆锥状	conical
圆锥体	cone
圆顶	dome
圆点	dot
图像	image
图坦卡蒙	Tutankhamen
图坦卡门	Tutankhamen
图恩	Thun
图书管理员	librarian
图书馆员	librarian
图案	design
图波列夫	Tupolev
图片报	Bild-Zeitung
图瓦	Tuva
图瓦卢	Tuvalu
图西族	Tutsi
图钉	thumbtack
图录	catalog
团队	team
𪢮	round
土匪	bandit
土器	earthenware
土堆	mound
土壤	soil
土库曼斯坦	Turkmenistan
土得掉渣	uncouth
土方工程	earthwork
土耳其	Turkey
土著	aboriginal
土豆网	Tudou
土豚	aardvark
土猪	aardvark
在一起	together
在下面	underneath
在地下	underground
在后	behind
在户外	outdoors
在深处	deeply
圩	dike
圪	phonetic
圭亚那	Guyana
圯	bridge
地下水	groundwater
地下通道	underpass
地下道	underpass
地下铁路	subway
地力	fertility
地图册	atlas
地塞米松	dexamethasone
地堑	trench
地平线	horizon
地广人稀	vast
地心吸力	gravitation
地拉那	Tirana
地排车	handcart
地方性	local
地板	floor
地标	landmark
地壳运动	diastrophism
地洞	tunnel
地滑	landslide
地球仪	globe
地球化学	geochemistry
地球物理	geophysics
地球物理学	geophysics
地理	geography
地理学	geography
地理学家	geographer
地理定位	geolocation
地窨	cellar
地窨子	cellar
地籍	cadaster
地缘战略	geostrategic
地缘政治学	geopolitics
地衣	lichen
地貌	geomorphology
地质	geology
地质学	geology
地质学家	geologist
地震	earthquake
地震仪	seismometer
址	location
均等	equal
均变论	uniformitarianism
坎儿井	karez
坎培拉	Canberra
坎帕拉	Kampala
坎昆	Cancún
坎特伯雷	Canterbury
坐浴桶	bidet
坐浴盆	bidet
坐药	suppository
坐骨	ischium
坐骨神经痛	sciatica
坑坑洼洼	bumpy
坡道	ramp
坦桑尼亚	Tanzania
坦率	frank
坩	crucible
坩埚	crucible
坯模	mold
垂幕	canopy
垂死	dying
垂直	perpendicular
垂钓	angling
垃圾筒	trashcan
型板	template
垓	boundary
垕	thick
垗	sacrifice
垛	pile
垛口	crenel
垝	collapsed
垣	wall
埃及	Egypt
埃及古物学	Egyptology
埃及古物学者	Egyptologist
埃及豆	chickpea
埃塞俄比亚	Ethiopia
埃奥罗斯	Aeolus
埃德蒙	Edmond
埃德蒙顿	Edmonton
埃拉特	Eilat
埃叙	Egypt-Syria
埃文河畔斯特拉特福	Stratford-upon-Avon
埃涅阿斯	Aeneas
埃米尔	amir
城址	townsite
城市化	urbanization
城池	city
城里人	townspeople
城镇化	urbanization
埏	boundary
域名抢注	cybersquatting
埭	dam
执政者	ruler
执照	license
埸	border
培亚	Praia
基加利	Kigali
基因型	genotype
基因学	genetics
基因改造	GM
基因组	genome
基地	al-Qaeda
基地组织	Al-Qaeda
基多	Quito
基岩	bedrock
基布兹	kibbutz
基底	plinth
基拉韦厄	Kilauea
基材	substrate
基板	substrate
基督徒	Christian
基督新教	Protestantism
基础结构	infrastructure
基础设施	infrastructure
基里巴斯	Kiribati
基里巴斯共和国	Kiribati
基金	fund
埼	headland
堄	parapet
坚不可摧	indestructible
坚固性	firmness
坚强不屈	steadfast
坚忍不拔	fortitude
坚果	nut
坚决	firm
坚若磐石	rock-solid
坚贞不屈	steadfast
坚贞不渝	unwavering
堆肥	compost
堆高机	forklift
埚	crucible
堞	battlements
堡垒	fort
堧	adjoin
堪培拉	Canberra
堪萨斯	Kansas
堪萨斯州	Kansas
堪舆	geomancy
堰	weir
报刊摊	newsstand
报告文学	reportage
报复心	vindictiveness
报复性	retaliatory
报应	karma
报摊	newsstand
报料人	informant
报章	newspapers
报童	paperboy
报道摄影师	photojournalist
堲	hate
场景	scene
堽	mound
块状	lump
塑化剂	plasticizer
塑性	plasticity
塔什干	Tashkent
塔吉克斯坦	Tajikistan
塔夫绸	taffeta
塔希提	Tahiti
塔帕斯	tapas
塔拉哈西	Tallahassee
塔拉瓦	Tarawa
塔斯曼尼亚	Tasmania
塔斯曼尼亚岛	Tasmania
塔木德经	Talmud
塔林	Tallinn
塔那那利佛	Antananarivo
涂料	paint
涂油于	anoint
塙	truly
塞内加尔	Senegal
塞浦路斯	Cyprus
塞尔特	Celtic
塞瓦斯托波尔	Sevastopol
塞纳河	Seine
塞维利亚	Seville
塞音	stop
填充物	filler
填地	landfill
填塞物	stuffing
填字游戏	crossword
尘土	dust
尘埃	dust
尘肺	pneumoconiosis
堑	chasm
堑壕	trench
墀	courtyard
境地	circumstances
境况	circumstances
境遇	circumstance
墅	villa
墈	cliff
垫子	cushion
垫被	mattress
墒土	moist
墓园	cemetery
墓场	graveyard
墓石	tombstone
墓窖	catacomb
墓志铭	epitaph
增塑剂	plasticizer
增强现实	AR
增稠剂	thickener
增量	increment
墟里	village
墨水瓶架	inkstand
墨尔本	Melbourne
墨西哥	Mexico
墨西哥人	Mexican
墨西哥辣椒	jalapeño
墨西拿	Messina
墨鱼	cuttlefish
坟场	cemetery
坟穴	grave
墺	building-plot
壁架	ledge
壁炉	fireplace
壁立千仞	lofty
壁纸	wallpaper
壁虎	gecko
𡒄	disappointed
压倒性	overwhelming
压力	pressure
压板	see-saw
压根	absolutely
压缩	compression
压缩器	compressor
压电体	piezo-electric
垒固	Loi-kaw
垒球	softball
圹	tomb
坏分子	troublemaker
坏死	necrosis
坏疽	gangrene
坏血病	scurvy
坜	hole
士人	scholar
士气	morale
壮美	magnificent
壶铃	kettlebell
寿司	sushi
寿喜烧	sukiyaki
寿材	coffin
夏	summer
夏利	Xiali
夏商周	Xia
夏士莲	Hazeline
夏威夷	Hawaii
夏威夷州	Hawaii
夏季	summer
夏延	Cheyenne
夏日	summertime
夏洛特敦	Charlottetown
夏尔巴人	Sherpa
外交官	diplomat
外交家	diplomat
外来人	foreigner
外来词	loanword
外来语	loanword
外侨	foreigner
外分泌	exocrine
外加剂	additive
外包	outsourcing
外国人	foreigner
外围	surrounding
外小腿	shin
外星人	extraterrestrial
外源	exogenous
外激素	pheromone
外用	external
外科学	surgery
外科手术	surgery
外号	nickname
外袍	robe
外设	peripherals
外貌主义	lookism
外邦人	gentile
外部连结	Tw
外阴	vulva
外头	outside
外显	visible
外高加索	Transcaucasia
多佛	Dover
多佛尔	Dover
多伦多	Toronto
多侧面	many-sided
多元性	diversity
多元文化主义	multiculturalism
多元论	pluralism
多元酯	polyester
多哈	Doha
多哥	Togo
多国	multinational
多多马	Dodoma
多妻制	polygamy
多媒体	multimedia
多孔	porous
多字节	multibyte
多学科	interdisciplinary
多寡	number
多层材	plywood
多山	mountainous
多工作业	multitasking
多工器	multiplexer
多工运作	multithreading
多巴胺	dopamine
多态	polymorphism
多才	multitalented
多才多艺	multitalented
多数	majority
多早晚	when?
多星	starry
多晶	polycrystalline
多模	multimode
多样性	variegation
多民族	multiethnic
多水分	juicy
多瑙河	Danube
多用户	multiuser
多用表	multimeter
多用途	multipurpose
多疑	mistrustful
多目的	multipurpose
多神教	polytheism
多神论	polytheism
多神论者	polytheist
多种	multiple
多种维生素	multivitamin
多站	multistation
多米诺骨牌	dominoes
多糖	polysaccharide
多细胞	multicellular
多义性	equivocality
多肉	fleshy
多肽	polypeptide
多胞形	polytope
多叶	leafy
多角体	polyhedron
多语言	multilingual
多边	multilateral
多边形	polygon
多邻国	Duolingo
多糖	polysaccharide
多重性	multiplicity
多金	rich
多面手	all-rounder
多面体	polyhedron
多音	polyphony
多项式	multinomial
多党	multiparty
夜	night
夜光	luminous
夜半	midnight
夜幕降临	nightfall
夜店	nightclub
夜景	nightscape
夜枭	owl
夜总会	nightclub
夜行性	nocturnality
夜莺	nightingale
梦境	dreamland
梦景	dreamscape
梦核	dreamcore
梦魇	nightmare
大使级	ambassadorial
大便干燥	constipated
大便秘结	constipation
大修	overhaul
大修道院长	abbot
大元帅	generalissimo
大力	energetically
大卡	kilocalorie
大吃一惊	flabbergasted
大吉岭	Darjeeling
大吞噬细胞	macrophage
大喜	exultation
大嘴鸟	toucan
大地水准面	geoid
大地洞	cavern
大地测量学	geodesy
大城市	metropolis
大堂	lobby
大墓地	necropolis
大坝	dam
大大咧咧	offhand
大夫	doctor
大媒	matchmaker
大客车	coach
大寨	Dazhai
大屠杀	massacre
大山	Dashan
大幅度	substantially
大厅	hall
大恭	feces
大意	careless
大拇指	thumb
大括弧	braces
大括号	braces
大提琴手	cellist
大教堂	cathedral
大数	Tarsus
大旗	banner
大日如来	Vairocana
大昭寺	Jokhang
大会报告起草人	rapporteur
大树菠萝	jackfruit
大比目鱼	halibut
大气候	atmosphere
大气圈	atmosphere
大水	flood
大油	lard
大洋洲	Oceania
大洋龙	halisaurus
大洲	continent
大浦洞	Taepodong
大浅盘	platter
大溪地	Tahiti
大漠	desert
大烟	opium
大灯	headlight
大牢	prison
大猩猩	gorilla
大理岩	marble
大理石	marble
大疆	DJI
大发	Daihatsu
大盗	thief
大盘子	platter
大众汽车	Volkswagen
大管	bassoon
大范围	large-scale
大系	compendium
大红	crimson
大羊驼	llama
大肉	pork
大能	almighty
大腕	bigwig
大脚怪	bigfoot
大腿	thigh
大致	roughly
大兴区	Daxing
大茴香子	aniseed
大菱鲆	turbot
大虫	tiger
大西国	Atlantis
大豆	soybean
大辟	decapitation
大农场	ranch
大部	most
大都	Dadu
大釜	cauldron
大锤	sledgehammer
大错	blunder
大镰刀	scythe
大开大合	wide-ranging
大阪	Osaka
大阿姨	auntie
大院	courtyard
大陆性	continental
大只	big
大餐	banquet
大马	Malaysia
大马士革	Damascus
大鹿	moose
大麦	barley
大黄蜂	bumblebee
大鼠	rat
天主教	Catholicism
天使	angel
天候	weather
天公地道	equitable
天刚亮	daybreak
天问一号	Tianwen-1
天坑	sinkhole
天寒地冻	frigid
天敌	predator
天文	astronomy
天文学	astronomy
天文学家	astronomer
天文馆	planetarium
天旱	drought
天枢	Dubhe
天权	Megrez
天气	weather
天然	natural
天璇	Merak
天玑	Phecda
天界	heaven
天空	sky
天竺牡丹	dahlia
天篷	canopy
天线宝宝	Teletubbies
天台	rooftop
天良	conscience
天蓝色	azure
天课	zakat
天门冬	asparagus
天门冬科	Asparagaceae
天际	horizon
天顶	zenith
天体主义	nudism
天体演化学	cosmogony
天体物理	astrophysics
天体物理学	astrophysics
天体物理学家	astrophysicist
天鹅	swan
太古	immemorial
太妃糖	taffy
太婆	great-grandmother
太子港	Port-au-Prince
太子党	princelings
太空人	astronaut
太空服	spacesuit
太空船	spaceship
太空行走	spacewalk
太长不看	DR
太阳光	sunlight
太阳灯	sunlamp
太阳眼镜	sunglasses
太阳镜	sunglasses
太阳雨	sunshower
太阳黑子	sunspot
太鲁阁族	Taroko
夫余	Pu'yo
夬	decisive
失修	disrepair
失坠	loss
失写症	agraphia
失意	disappointed
失忆症	amnesia
失败主义	defeatism
失败者	loser
失明症	blindness
失温症	hypothermia
失物招领	lost-and-found
失读症	alexia
失身分	demeaning
失重	weightlessness
夷然	calm
夹脚拖	flip-flops
夹脚拖鞋	flip-flops
夹钳	tongs
夹头	chuck
奄列	omelet
奇事	marvel
奇卡诺人	Chicano
奇妙	wonderful
奇才	genius
奇瓦瓦	Chihuahua
奇观	spectacle
奇诡	strange
奇迹	miracle
奈洛比	Nairobi
奈良	Nara
奈飞	Netflix
奉承者	flatterer
奉献精神	dedication
奉现	offering
奎星	Kuixing
奏鸣曲	sonata
奂	excellent
契卡	Cheka
契据	deed
奔驰	Mercedes-Benz
套利	arbitrage
套利者	arbitrager
套裤	leggings
套钟	chime
套鞋	overshoes
奜	big
奠基石	cornerstone
奢	extravagant
奢靡	extravagant
奥克拉荷马	Oklahoma
奥克拉荷马州	Oklahoma
奥切诺斯	Oceanus
奥国	Austria
奥地利	Austria
奥德修斯	Odysseus
奥托	Otto
奥斯瓦尔德	Oswald
奥斯陆	Oslo
奥林匹克	Olympic
奥林巴斯	Olympus
奥氏体	austenitic
奥波莱	Opole
奥尔巴尼	Albany
奥尔良	Orléans
奥特曼	Ultraman
奥胡斯	Aarhus
奥腊涅斯塔德	Oranjestad
奥兰多	Orlando
奥西娜斯	Oceanus
奥迪	Audi
奥迪修斯	Odysseus
奥里里亚	Aurelia
奥马哈	Omaha
奥黛丽	Audrey
奋起湖	Fenchihu
奰	anger
女人	woman
女人	wife
女修道院	convent
女仆	maid
女傧相	bridesmaid
女儿	daughter
女公爵	duchess
女友	girlfriend
女婿	son-in-law
女孩	girl
女孩子	girl
女巫	witch
女性主义	feminism
女性厌恶	misogyny
女性贬抑	misogyny
女房东	landlady
女朋友	girlfriend
女权主义	feminism
女武神	valkyrie
女王	queen
女的	woman
女皇	empress
女管家	housekeeper
女继承人	inheritress
女舍监	matron
女衬衫	blouse
女警	policewoman
女高音	soprano
奴	slave
奴仆	servant
奴性	servility
奴隶	slave
奴隶制	slavery
奴隶制度	slavery
奶汁烤	gratin
奶油果	avocado
奶站	dairy
奶酪火锅	fondue
奶黄	custard
奸商	profiteer
奸宄	evildoer
她	she
她们	they
好事之徒	busybody
好吃	tasty
好好	well
好战	warlike
好氧	aerobic
好生	quite
好笑	laughable
好言好语	sincere
如今	nowadays
如来佛	Tathagata
如是	thus
如此	so
如火	fiery
如画	picturesque
如痴如醉	mesmerized
如花	flowery
如若	if
如草	grassy
妄自尊大	arrogance
妍	beautiful
妍丽	beautiful
妓	prostitute
妓女	prostitute
妓寨	brothel
妓馆	brothel
妖媚	seductive
妖孽	evildoer
妖物	monster
妖术	sorcery
妖言	heresy
妖魔	demon
妙笔	talented
妙语	witticism
妞	girl
妥善	appropriate
妮维娅	Nivea
妮维雅	Nivea
妯娌	sisters-in-law
妻子	wife
妻室	wife
姅	menstruation
姆妈	mother
姆巴巴内	Mbabane
始祖鸟	Archaeopteryx
姗姗	leisurely
姑且	tentatively
姑父	uncle
委内瑞拉	Venezuela
委员会	committee
委婉词	euphemism
委婉语	euphemism
奸情	adultery
姨太太	concubine
侄	nephew
侄女	niece
侄子	nephew
侄孙	grandnephew
姬妾	concubine
姻亲	in-laws
威廉斯堡	Williamsburg
威斯康星	Wisconsin
威斯康星州	Wisconsin
威斯康辛	Wisconsin
威望	prestige
威尔士	Wales
娉	graceful
娓娓	engagingly
娘胎	womb
娱遣	amusement
娠	pregnant
娼	prostitute
娼女	prostitute
娼妓	prostitute
娼妇	prostitute
娼家	brothel
婆罗门	Brahmin
婉词	euphemism
婊	prostitute
婚外	extramarital
婚嫁	marriage
婚神星	Juno
婞	upright
妇	woman
妇女	woman
妇洗器	bidet
妇科	gynecology
婪	avaricious
婬	obscene
婷	graceful
婺	beautiful
婼	recalcitrant
婽	good
媄	beautiful
媒妁	go-between
媒婆	matchmaker
媒质	medium
媒体	media
媕婀	indecisive
媚词	flattery
媠	beautiful
媢	envious
媳	daughter-in-law
媺	beautiful
妈妈桑	madam
妈祖	Matsu
嫁妆	dowry
嫁娶	marriage
嫂	sister-in-law
嫂子	sister-in-law
嫌忌	suspicion
嫌恨	hatred
嫌猜	suspicion
嫘萦	rayon
嫚	insult
嫠	widow
嫣	sweet
嫩主	newbie
嫩苗	seedling
娴淑	ladylike
婳	tranquil
娆	graceful
嬉	amusement
娇弱	delicate
娇美	dainty
婴儿期	infancy
婴孩	infant
婴幼儿	baby
婴猴	galago
嬿	lovely
孀	widow
孀婺	widow
娈	beautiful
娈童恋	pederasty
子午线	meridian
子品牌	sub-brand
子囊菌	ascomycete
子夜	midnight
子女	children
子宫托	pessary
子宫颈	cervix
子层	sublayer
子模型	submodel
子民	people
子爵	viscount
子癫前症	pre-eclampsia
子程序	subroutine
子粒	seed
子系统	subsystem
子网	subnetwork
子规	cuckoo
子集	subset
子音	consonant
孑孓	wiggler
孔丘	Confucius
孔方兄	coll.
孔雀	peafowl
孕	pregnant
孕期	pregnancy
孕激素	progesterone
孕酮	progesterone
孖	twins
字图	glyph
字尾	suffix
字幕	subtitles
字汇	Zihui
字林	Zilin
字段	numeric
字母表	alphabet
字眼	wording
字节跳动	ByteDance
字素	grapheme
字迹	handwriting
字首	prefix
存在主义	existentialism
存心	deliberately
存根	stub
存量	reserves
孛	comet
孜孜矻矻	diligently
孜然芹	cumin
孟加拉国	Bangladesh
孢	spore
孢子	spore
季候	season
季节性	seasonal
季风	monsoon
季黎诺	Quirinius
孤儿	orphan
孤孀	widow
孤孑	lonesome
孤独症	autism
孤绝	isolated
孤高	arrogant
孩儿	child
孩子	child
孩子们	children
孩童	child
孬种	coward
孱	feeble
孱弱	delicate
孱头	coward
学位论文	dissertation
学前班	preschool
学友	schoolmate
学究	pedant
学童	schoolchild
学级	class
学者	scholar
孺	child
𡥧	last
孪	twins
它	it
它们	they
它本身	itself
宄	traitor
宅子	house
宇宙	universe
宇宙学	cosmology
宇宙号	Kosmos
宇宙飞船	spaceship
宇航员	astronaut
宇航服	spacesuit
守宫	gecko
守时	punctual
守望台	watchtower
守军	defenders
守门人	gatekeeper
守门员	goalkeeper
安保	security
安卡拉	Ankara
安吉星	OnStar
安哥拉	Angola
安圭拉	Anguilla
安培表	ammeter
安塔那那利佛	Antananarivo
安定化	stabilization
安宁片	meprobamate
安宁病房	hospice
安息国	Parthia
安息日	Sabbath
安息香科	Styracaceae
安慰剂	placebo
安提瓜岛	Antigua
安曼	Amman
安格斯	Angus
安格斯牛	Angus
安乐死	euthanasia
安石榴	pomegranate
安稳	steady
安联	Allianz
安详	serene
安道尔	Andorra
安养院	hospice
完备性	completeness
完完全全	completely
完美	perfect
完美主义者	perfectionist
宏大	great
宏碁	Acer
宏碁集团	Acer
宏观经济	macroeconomic
宏观经济学	macroeconomics
宏观调控	macro-control
宗主权	suzerainty
宗教	religion
宗派	sect
宗派主义	sectarianism
官僚主义	bureaucracy
官办	government-run
宙斯	Zeus
定型水	hairspray
定居者	settler
定居点	settlement
定州市	Dingzhou
定时器	timer
定标器	scaler
定殖	colonization
定洋	deposit
定理	theorem
定当	necessarily
定音鼓	timpani
定额组	quorum
宜人	nice
宜家	IKEA
宜居	livable
客户	client
客观性	objectivity
宣武门	Xuanwumen
宣礼塔	minaret
宣誓供词证明	deposition
宣誓书	affidavit
室内	indoor
室友	roommate
室外	outdoor
宫阙	palace
宫颈	cervix
宴席	banquet
宵	night
家僮	servant
家庭主夫	househusband
家庭主妇	housewife
家庭作业	homework
家庭教师	tutor
家庭煮夫	househusband
家政	housekeeping
家乐福	Carrefour
家灶	hearth
家童	servant
家里	home
宿	constellation
宿营地	camp
宿酒	hangover
宿醉	hangover
宿雾	Cebu
寁	swift
寂寂	quiet
寂寂无名	unknown
寂静	quiet
寄件人	sender
寄宿生	boarder
寄物处	cloakroom
寄生物	parasite
密克罗尼西亚	Micronesia
密宗	tantra
密文	ciphertext
密林	jungle
密歇根	Michigan
密歇根州	Michigan
密特朗	Mitterrand
密码学	cryptography
密致	compact
密苏里	Missouri
密苏里州	Missouri
密西根	Michigan
密西根州	Michigan
密西西比	Mississippi
密西西比州	Mississippi
密集恐惧症	trypophobia
密云区	Miyun
富商巨贾	tycoon
富士通	Fujitsu
富于想像	imaginative
富纳富提	Funafuti
富良野	Furano
富色彩	colorful
富裕	prosperous
富贵寿考	rank
寒战	shiver
寓所	dwelling
寞	lonesome
寡妇	widow
寡糖	oligosaccharide
寡头	oligarch
寡头垄断	oligopoly
寡头政治	oligarchy
寝具	bedding
寤寐	constantly
寥廓	boundless
实利主义	utilitarianism
实力	strength
实力主义	meritocracy
实地	on-site
实打实	no-nonsense
实施例	embodiment
实业家	industrialist
实用主义	pragmatism
实话	truth
实际参数	argument
实际性	practicality
审判者	judge
审慎	prudent
审计长	auditor
写照	portrayal
宽宏	magnanimous
宽宏大量	generous
宽屏	widescreen
宽展	happy
宽带	broadband
宽度	width
宽泛	wide-ranging
宽爽	happy
宽频	broadband
寮	Laos
宝可梦	Pokémon
宝塔	pagoda
宝宝	darling
宝岛	Formosa
宝座	throne
宝丽来	Polaroid
封建主义	feudalism
封建制度	feudalism
封条	seal
封闭性	closed
封斋节	Lent
射击学	ballistics
射灯	spotlight
射线	ray
射门	soccer
将官	general
将帅	commander-in-chief
将军肚	potbelly
专事	specialized
专家	expert
专属	proprietary
专政	dictatorship
专案	project
专业化	specialization
专业性	professionalism
专科院校	academy
专门家	specialist
尊鱼	trout
寻呼机	pager
寻回犬	retriever
寻常	usual
寻水术	dowsing
对句	couplet
对工	proper
对工儿	proper
对抗性	antagonistic
对敌者	rival
对数	logarithm
对于	regarding
对案	counterproposal
对氨基苯丙酮	p-aminopropiophenone
对流	convection
对称性	symmetry
对讲电话	intercom
对证	confrontation
对跖点	antipode
导论	introduction
导轨	slideway
小丑	clown
小丘	hill
小二	waiter
小便器	urinal
小便斗	urinal
小便池	urinal
小偷	thief
小儿经	Xiao'erjing
小儿麻痹病毒	poliovirus
小包	packet
小吃	snack
小型核武器	mini-nuke
小型柜橱	cabinet
小夜曲	serenade
小姑子	sister-in-law
小娃	child
小娃娃	baby
小孩堤防	Kinderdijk
小孩子	child
小写	lowercase
小岩洞	grotto
小岛	isle
小巧玲珑	delicate
小巴	minibus
小巷	alley
小年轻	youngster
小径	alley
小心翼翼	careful
小扁豆	lentil
小打小闹	small-scale
小括号	parentheses
小提琴手	violinist
小支气管	bronchiole
小斑点	speckle
小松菜	komatsuna
小标题	subheading
小树林	grove
小步舞曲	minuet
小毛虫	slug
小河	creek
小泡	vesicles
小淘气	Rogue
小淘气	rascal
小清新	hipster
小瀑布	cascade
小牛肉	veal
小牝牛	heifer
小狗	pup
小百科全书	micropedia
小碟子	saucer
小米	Xiaomi
小米	millet
小米辣	xiaomila
小粉	starch
小精灵	elf
小红莓	cranberry
小组	group
小组委员会	subcommittee
小羊	lamb
小羚羊	gazelle
小考	quiz
小舌	uvula
小船	boat
小虾	shrimp
小袋	pouch
小计	subtotal
小说家	novelist
小谎	fib
小猫	kitten
小起重机	jack
小路	lane
小辫	pigtail
小酒馆	bistro
小钢珠	pachinko
小镇	village
小铲子	trowel
小阿姨	auntie
小鸡	chick
小额融资	microfinance
小食	snack
小松糕	muffin
小鹅	gosling
小黄瓜	gherkin
小鼠	mouse
少	young
少儿	child
少女峰	Jungfrau
少年人	youngster
尖刀	dagger
尖牙	fang
尖声啼哭	squeal
尢	lame
尤其	especially
尤文图斯	Juventus
尤为	especially
尬	awkward
尰	swell
就职典礼	inauguration
尴尬	awkward
尻	rump
尼亚美	Niamey
尼加拉瓜	Nicaragua
尼古西亚	Nicosia
尼哥底母	Nicodemus
尼布甲尼撒	Nebuchadnezzar
尼散月	Nisan
尼日利亚	Nigeria
尼桑	Nissan
尼泊尔	Nepal
尼科西亚	Nicosia
尼雅	Niya
尾气	exhaust
尾注	endnote
尾闾骨	coccyx
尾韵	rhyme
尿布	diaper
尿液	urine
尿片	diaper
尿脬	bladder
局外中立	neutralism
局部性	local
屁屁	bottom
屁眼	anus
屁股眼	anus
屁话	bullshit
屄样儿	vulgar
居人	inhabitant
居住者	inhabitant
居宅	dwelling
居所	residence
居民	resident
屈伦博赫	Culemborg
屈光度	diopter
屈曲	crooked
屈膝礼	curtsy
屋外	outdoors
屋面	roof
屋顶	roof
尸检	autopsy
尸身	corpse
尸体	corpse
尸体剖检	autopsy
屏幕保护程序	screensaver
屏蔽罐	cask
屏障	barrier
屐	clogs
屉	drawer
屠户	butcher
屡加	ply
屡劝不听	incorrigible
屣	slippers
层压	lamination
层子	stratum
层次分明	layered
层理	stratification
屦	sandals
屪	penis
属吏	underling
属灵	spiritual
屯子	village
屯落	village
山丘	hill
山坡	hillside
山坞	nook
山崖	cliff
山巅	summit
山核桃	hickory
山毛榉	beech
山水	Sansui
山沟沟	backwoods
山墙	gable
山竹	mangosteen
山羊绒	cashmere
山羊胡子	goatee
山胡桃木	hickory
山茶	camellia
山茶花	camellia
山莓	raspberry
山萮菜	wasabi
山葵	wasabi
山贼	brigand
山达基	Scientology
山雀	tit
山雉	pheasant
山青水灵	scenic
山顶	hilltop
山麓	foothills
冈比亚	Gambia
岩仓	Iwakura
岩土体	gneiss
岩沙海葵毒素	palytoxin
岩石	rock
岩羊	bharal
岸	bank
岸边	shore
峇	cave
峪	valley
岛屿	island
岛民	islander
峡	gorge
峡湾	fjord
崇拜者	worshipper
崇祯	Chongzhen
崎	mountainous
昆士兰	Queensland
崱	lofty
嵬	rocky
嶟	precipitous
屿	islet
巉	rugged
巅	summit
岩床	bedrock
川滇藏	Sichuan
州立	state-run
巡逻队	army
巢	nest
工件	workpiece
工位	workstation
工作流	workflow
工作流程	workflow
工作狂	workaholic
工作者	worker
工作表	worksheet
工作过度	overwork
工作量	workload
工具箱	toolbox
工坊	workshop
工字梁	I-beam
工字钢	I-beam
工时	man-hour
工业	industry
工业七国集团	G7
工程学	engineering
工笔	gongbi
工头	foreman
左口鱼	flounder
左右共利	ambidextrous
左撇子	left-hander
左氧氟沙星	levofloxacin
左至右	left-to-right
左轮手枪	revolver
左近	nearby
巨	huge
巨乳	busty
巨人	giant
巨嘴鸟	toucan
巨噬细胞	macrophage
巨型	giant
巨大	huge
巨石	boulder
巨石柱群	Stonehenge
巨蟒	python
巫蛊	witchcraft
巫术	witchcraft
巫裔	Malaysia
差别	difference
差异	difference
差异性	difference
差误	mistake
差谬	error
巯	hydrosulfuryl
已婚	married
已婚已育	married
已成形	preformed
已经	already
巴伐利亚	Bavaria
巴伦西亚	Valencia
巴克斯	Bacchus
巴克特里亚	Bactria
巴克科斯	Bacchus
巴利文	Pali
巴力	Baal
巴勒斯坦	Palestine
巴勒莫	Palermo
巴基斯坦	Pakistan
巴塞尔	Basel
巴塞罗那	Barcelona
巴宰族	Pazeh
巴巴多斯	Barbados
巴库	Baku
巴拉克	Barack
巴拉圭	Paraguay
巴拉马利波	Paramaribo
巴拿马	Panama
巴斯特尔	Basseterre
巴林	Bahrain
巴枯宁主义	Bakuninism
巴格达	Baghdad
巴比伦	Babylon
巴氏	Pasteur
巴氏杀菌	pasteurization
巴乌	bawu
巴尔多禄茂	Bartholomew
巴尔干	Balkan
巴特纳	Batna
巴西	Brazil
巴西利亚	Brasilia
巴西战舞	capoeira
巴贝多	Barbados
巴阿	Pakistan-Afghan
巴马科	Bamako
巴黎	Paris
巷子	alley
市场化	marketization
市场营销	marketing
市长	mayor
布列塔尼	Brittany
布列斯特	Brest
布加勒斯特	Bucharest
布希威克	Bushwick
布干维尔	Bougainville
布拉德福德	Bradford
布拉柴维尔	Brazzaville
布拉格	Prague
布拉索夫	Braşov
布拉萨市	Brazzaville
布拉迪斯拉发	Bratislava
布料	fabric
布松布拉	Bujumbura
布林迪西	Brindisi
布法罗	Buffalo
布洛芬	ibuprofen
布洒器	disperser
布尔什维克	Bolshevik
布尔乔亚	bourgeoisie
布尔诺	Brno
布琼布拉	Bujumbura
布痕瓦尔德	Buchenwald
布谷	cuckoo
布线	wiring
布莱克本	Blackburn
布莱顿	Brighton
布农族	Bunun
布达佩斯	Budapest
布达拉宫	Potala
布里奇顿	Bridgetown
布里斯托	Bristol
布里斯班	Brisbane
布里特妮	Britney
布隆方丹	Bloemfontein
布隆迪	Burundi
布雷斯特	Brest
布鲁克林	Brooklyn
布鲁塞尔	Brussels
布鲁姆斯伯里	Bloomsbury
帆船	sailboat
希伯来	Hebrew
希尔弗瑟姆	Hilversum
希腊	Greece
帔	cape
帕利基尔	Palikir
帕尼巴特	Panipat
帕拉马里博	Paramaribo
帕提亚人	Parthian
帕斯	Perth
帕特里夏	Patricia
帕特丽夏	Patricia
帕玛森	Parmesan
帕皮提	Papeete
帕福斯	Paphos
帕马森	Parmesan
帖撒罗尼迦	Thessalonica
帚	broom
帛	silk
帛金	HK
帝	emperor
帝力	Dili
帝国主义	imperialism
帟	canopy
帨	handkerchief
席凡宁根	Scheveningen
帐幔	curtain
帐幕	tent
帐户	bank
帐目	account
帐帘	drapery
帐号	account
带劲	energetic
带宽	bandwidth
带感	electrifying
带红色	reddish
带扣	buckle
带露	dewy
带头人	leader
常任	permanent
常常	frequently
常春藤	ivy
常绿	evergreen
常青	evergreen
常青藤	ivy
帽匠	milliner
幄	tent
幔	curtain
帜	flag
幡	banner
幢	banner
幢幢	dancing
币种	currency
帮手	helper
帱	canopy
幯	wipe
干系	responsibility
干扰素	interferon
平均主义	egalitarianism
平壤	Pyongyang
平壤市	Pyongyang
平常日	weekday
平流层	stratosphere
平白无故	inexplicably
平稳	smooth
平等主义	egalitarianism
平胸	flat-chested
平行四边形	parallelogram
平衡觉	equilibrioception
平谷区	Pinggu
平锅	pan
平顺	Pingshun
年尊	senior
年少无知	unsophisticated
年年	yearly
年老	aged
年载	years
年轻	young
年长	senior
年青	youthful
幵	level
幸喜	fortunately
幸好	fortunately
干事长	secretary-general
干案	Singapore
幻	fantasy
幻觉剂	hallucinogen
幻象	illusion
幼	young
幼时	childhood
幼兽	cub
幼虫	larva
幽暗	gloom
幽闭恐惧	claustrophobia
幽闭恐惧症	claustrophobia
几	almost
几丁	chitin
几丁质	chitin
几乎	almost
几何学	geometry
几内亚比绍	Guinea-Bissau
几时	when?
几至	almost
几进宫	recidivist
庇护所	shelter
庈	person
床侧	bedside
床罩	bedspread
床虱	bedbug
床边	bedside
床铺	bed
序列	sequence
序幕	prologue
序曲	overture
序言	preface
底数	base
底栖生物	benthos
底漆	primer
底特律	Detroit
底盘	chassis
底部	bottom
庖	kitchen
度量衡	measurement
座堂	cathedral
座椅	seat
座头市	Zatoichi
库仑计	voltameter
库伦	Kulun
库存	stock
库布里克	Kubrick
库拉索	Curaçao
库尔德斯坦	Kurdistan
库肯霍夫公园	Keukenhof
库页岛	Sakhalin
庬	huge
庭院	courtyard
庶妻	concubine
庶室	concubine
康乃狄克	Connecticut
康涅狄格	Connecticut
康涅狄格州	Connecticut
庸俗化	debasement
庸才	mediocrity
庸碌	mediocre
厢式车	van
廉价	cheaply-priced
廉洁	incorruptible
廌	unicorn
廒	granary
厨	kitchen
厨司	chef
厨子	cook
庙口	Miaokou
庙宇	temple
废墟	ruins
广博	extensive
广告主	advertiser
广告宣传	advertising
广告宣传画	placard
广告拦截器	ad-blocker
广告牌	billboard
广场	plaza
广场恐怖症	agoraphobia
广场恐惧	agoraphobia
广场恐惧症	agoraphobia
广子	ad
广岛	Hiroshima
广度	breadth
广式	Cantonese-style
广播网	network
广泛	wide
广为	widely
广袤	vast
廥仓	granary
𪪞	wall
庐	hut
廱	harmonious
厅堂	hall
延展性	ductability
延性	ductility
延庆区	Yanqing
廷布	Thimphu
建三江	Jiansanjiang
建物	structure
建立者	founder
建筑师	architect
建党	party-founding
廿	twenty
弊案	scandal
式样	style
弓弦	bowstring
弓弦儿	bowstring
弓箭手	archer
引信	fuze
引火柴	kindling
引爆装置	detonator
引用句	quotation
引种	agriculture
引语	quotation
弗吉尼亚州	Virginia
弗拉基米尔	Vladimir
弗拉芒	Flemish
弗罗茨瓦夫	Wroclaw
弗莱福兰	Flevoland
弗里敦	Freetown
弗里斯兰	Friesland
弗雷德里克顿	Fredericton
弟媳	sister-in-law
弟子	disciple
弧	arc
弧形	curve
弧线	arc
弩	crossbow
弩弓	crossbow
弱视	amblyopia
张力	tension
张惠妹	A-Mei
张王李赵	anyone
强健	sturdy
强力	powerful
强力胶	superglue
强大	formidable
强奸犯	rapist
强奸罪	rape
强烈	strong
弹丸	pellet
弹夹	magazine
弹子	towrope
弹指之间	instantly
弹片	shrapnel
弹片	plectrum
弹珠台	pinball
弹球盘	pachinko
弹痕累累	bullet-riddled
弹簧	spring
弹药	ammunition
弹跳板	springboard
弹头	warhead
弥勒	Maitreya
弥赛亚	Messiah
彗	broom
彗星	comet
彘	swine
形上	metaphysics
形胜	advantageous
形单影只	solitary
形容词	adjective
形容辞	adjective
形态发生素	morphogen
形核	nucleation
形而上学	metaphysics
形变	deformation
形貌	appearance
彤	red
彩弹	paintball
彩泥	playdough
彩声	applause
彪子	simpleton
彬	urbane
彬彬	refined
彬马那	Pyinmana
影像	image
影儿	shadow
影院	cinema
影音	audiovisual
影响层面	impact
彴	bridge
彸	restless
彼尔姆	Perm
征戍	garrison
征战	campaign
征服者	conqueror
很是	quite
律	law
律吕	tuning
律师	lawyer
后备	reserve
后备军	rearguard
后传	sequel
后勤	logistics
后味	aftertaste
后挡板	backboard
后效	after-effect
后殖民	postcolonial
后母	stepmother
后海	Houhai
后灯	taillight
后父	stepfather
后现代主义	postmodernism
后甲板	afterdeck
后裔	descendant
后制	postproduction
后见之明	hindsight
后颈	nape
径流	runoff
径直	directly
徒劳	futile
徒步旅行	hiking
得中	moderate
得了	emphatically
得克萨斯	Texas
得克萨斯州	Texas
得可以	awfully
得票	vote-getting
从不	never
从来不	never
从俭	economical
从句	clause
从严	strict
从子	nephew
从宽	lenient
从属	subordinate
从未	never
从业者	practitioner
从者	attendant
复活节	Easter
循道宗	Methodism
徬	irresolute
微不足道	negligible
微光	glimmer
微动开关	microswitch
微型	miniature
微妙	subtle
微明	twilight
微晶	microcrystal
微晶片	microchip
微生物	microorganism
微生物学	microbiology
微生物学家	microbiologist
微睡眠	microsleep
微秒	microsecond
微管蛋白	tubulin
微粒体	microsome
微丝	microfilament
微缩胶卷	microfilm
微胖	stoutish
微胶囊技术	microencapsulation
微菌	microorganism
微处理器	microprocessor
微处理机	microprocessor
微血管	capillary
微表情	microexpression
微观经济	microeconomic
微观经济学	microeconomics
微距	close-up
微醺	tipsy
微量白蛋白	microalbumin
微电子	microelectronics
微电子学	microelectronics
微电脑	microcomputer
征候	sign
征状	symptom
德克萨斯	Texas
德古西加巴	Tegucigalpa
德国	Germany
德国结	pretzel
德国酸菜	sauerkraut
德士	Singapore
德川	Tokugawa
德式	German-style
德意志	Deutschland
德雷斯顿	Dresden
德黑兰	Tehran
徽帜	banner
徽标	emblem
心伤	broken-hearted
心包	pericardium
心土	subsoil
心地	character
心弦	heartstrings
心律不整	arrhythmia
心律不齐	arrhythmia
心律失常	arrhythmia
心悸	palpitation
心爱	beloved
心慈手软	merciful
心智	wisdom
心狠手辣	merciless
心理分析	psychoanalysis
心理学	psychology
心理学家	psychologist
心目	mind
心硬	hard-hearted
心累	drained
心结	preoccupation
心绞痛	angina
心声	aspiration
心肌	myocardium
心肌炎	myocarditis
心肝宝贝	sweetheart
心肺	cardiopulmonary
心胸狭窄	petty
心胸狭隘	narrow
心腹	confidant
心胆	courage
心血管	cardiovascular
心跳过缓	bradycardia
心防	guardedness
心电感应	telepathy
心灵上	spiritual
心灵感应	telepathy
心头好	favorite
必备	essential
必将	inevitably
必杀技	finisher
必要性	necessity
忉	grieved
忍俊	smiling
忍者	ninja
忐忑	apprehensive
志愿者	volunteer
忘性	forgetfulness
忙碌	busy
忠	loyal
忠实	faithful
快可立	Quickly
快慢	speed
快手	Kuaishou
快板	allegro
快乐	happy
快当	quick
快讯	newsflash
快转	fast-forward
快速	fast
快递员	courier
快门	shutter
忭	delighted
念力	psychokinesis
念头	thought
忻	happy
忽地	suddenly
忽布	hops
忽然	suddenly
怊	sorrowful
怍	ashamed
怎	how
怎奈	however
怏	discontented
怒气	anger
怒冲冲	furiously
怔	terrified
怔住	dumbfounded
怚	dull
思想家	thinker
思想意识	consciousness
思觉失调	psychosis
思路敏捷	quick-witted
思乡病	homesickness
怠惰	idleness
怡人	delightful
急公好义	public-spirited
急剧	rapid
急吼吼	impatient
急忙	hastily
急急忙忙	hurriedly
急性	acute
急流	torrent
急着	urgently
急要	urgent
急遽	rapid
急骤	rapid
性事	sex
性交高潮	orgasm
性冷淡	frigidity
性命	life
性子	temper
性学	sexology
性急	impatient
性欲高潮	orgasm
性短讯	sext
性能	function
性腺	gonad
怨尤	resentment
怨忿	resentment
怨毒	rancor
怨言	complaint
怪手	backhoe
怪讶	astonished
怫	anger
怫	anxious
怯懦	timid
怯生	shy
怯生生	shy
怵然	fearful
恂	sincere
恒定	constant
恒心	perseverance
恒温器	thermostat
恉	purport
恌	frivolous
恐同症	homophobia
恐怖主义	terrorism
恐怖主义者	terrorist
恐怖分子	terrorist
恐怖症	phobia
恐惧症	phobia
恐旷症	agoraphobia
恐水病	rabies
恐韩症	Koreaphobia
恐龙总目	Dinosauria
恐龙类	dinosaurs
恔	cheerful
恙	sickness
恚	rage
恝	indifferent
恟	scared
恢复期	convalescence
恢恢	extensive
耻	humiliation
恧	ashamed
恩公	benefactor
恩斯赫德	Enschede
恩贾梅纳	N'Djamena
恫	frighten
恭	respectful
恭谨	deferential
恰吉	Chucky
恰帕斯州	Chiapas
悁	impatient
悃	sincere
悄悄咪咪	stealthily
悦	pleased
悆	happy
悉尼	Sydney
悍勇	intrepid
悔意	remorse
悖逆	contrary
悚	frightened
悜	obscure
悠扬	melodious
悢	melancholy
患者	patient
悰	joy
悲伤	sad
悲切	mournful
悲剧性	tragic
悲喜剧	tragicomedy
悲愁	melancholy
悲恸	mournful
悲戚	mournful
悲苦	forlorn
悲观	pessimistic
怅	regretful
怅怅然	disappointed
闷声闷气	muffled
悷	sorrowful
悻	angry
悻然	angrily
凄怆	pitiful
凄楚	sad
凄凉	mournful
凄然	distressed
凄苦	bleak
情侣鹦鹉	lovebirds
情分	friendship
情势	situation
情报	information
情境	situation
情急	anxious
情意	affection
情景喜剧	sitcom
情真意切	heartfelt
情谊	friendship
情调	ambience
惓	earnest
惠普	Hewlett-Packard
惠誉	Fitch
惠灵顿	Wellington
恶凶凶	fierce
恶名昭著	infamous
恶唑啉	oxacillin
恶唑啉酮	oxacillin
恶梦	nightmare
恶性通货膨胀	hyperinflation
恶棍	scoundrel
恶毒	malicious
恶辣	ruthless
惰	lazy
恼火	annoyed
想家	homesick
想象力	imagination
惶	dread
惶恐	terrified
恻	sorrowful
恻隐之心	compassion
愁绪	melancholy
愃	well-being
愉	pleased
愉快	cheerful
意外事故	accident
意大利	Italy
意大利直面	spaghetti
意大利青瓜	zucchini
意大利面	spaghetti
意式	Italian-style
意志	will
意志力	willpower
意念移物	telekinesis
意料之外	unexpected
意气相投	congenial
意识形态	ideology
愐	shy
愓	profligate
愕	startled
愚蒙	ignorant
愚鲁	dull-witted
爱丁堡	Edinburgh
爱侣	lovers
爱哭鬼	crybaby
爱国主义	patriotism
爱国者	patriot
爱奇艺	iQiyi
爱奥华	Iowa
爱奥华州	Iowa
爱好者	amateur
爱彼迎	Airbnb
爱德蒙	Edmond
爱意	love
爱慕虚荣	vain
爱斯基摩	Eskimo
爱普生	Epson
爱沙尼亚	Estonia
爱尔兰	Ireland
爱理不理	indifferent
爱留根纳	Eriugena
爱维养	Evian
爱荷华	Iowa
爱莫利维尔	Emeryville
爱词霸	iCIBA
爱财	avaricious
爱达荷	Idaho
爱达荷州	Idaho
爱面子	proud
惬	content
惬意	satisfied
感人	touching
感光	light-sensitive
感知力	perceptivity
愧	ashamed
愧怍	ashamed
悫	honest
愮	distressed
忾	anger
慅	agitated
慆	rejoice
慇	solicitous
慈善机构	charity
慈悲	mercy
慈母	warm
慊	dissatisfied
慊	contented
慌里慌张	flustered
慕田峪	Mutianyu
惨事	disaster
惨酷	savage
惨重	disastrous
惭	ashamed
惭愧	ashamed
恸	grief
慢	slow
慢化剂	moderator
慢悠悠	unhurried
慢慢	slowly
慢速	slow
惯有	customary
悫	honest
慥	sincere
慧	intelligent
虑病症	hypochondria
慱	sad
悭	stingy
悭俭	miserly
悭吝	stingy
慵	lethargic
庆典	celebration
庆祝会	celebration
欲望	desire
欲火	lust
忧灼	worrying
忧郁	sullen
憃	foolish
惫	exhausted
惫懒	listless
憋屈	sullen
憍	arrogant
凭据	evidence
凭空捏造	frame-up
憧憧	dancing
憩室炎	diverticulitis
憪	composed
憬	awaken
宪政主义	constitutionalism
宪章	charter
憺	peace
恳	earnest
应激源	stressor
应当	should
应该	should
应变力	adaptability
懔	fear
蒙	honest
懠	angry
懑	melancholy
懑然	dejectedly
懥	enraged
懦	faint-hearted
懦夫	coward
懦弱	cowardly
恹恹	weak
惩罚性	punitive
懵	stupid
懒	lazy
懒人沙发	beanbag
懒怠	lazy
懒散	indolent
懒洋洋	lazily
怀俄明	Wyoming
怀俄明州	Wyoming
怀柔区	Huairou
怀乡	homesick
悬岩	cliff
悬挂式滑翔	hang-gliding
悬挂式滑翔机	hang-glider
悬疑	suspense
悬臂	cantilever
惧内	henpecked
惧高症	acrophobia
懿	virtuous
恋尸癖	necrophilia
恋童犯	pedophile
恋童癖	pedophilia
戆督	stupid
戈斯拉尔	Goslar
戍	garrison
成化	Chenghua
成千	thousands
成员	member
成年者	adult
成心	intentionally
成文法	statute
成本	manufacturing
成核	nucleation
成瘾性	addictiveness
我	I
我人	we
我们	we
我方	we
戒备森严	heavily-guarded
戒命	prohibition
戒惧	wary
戒断	withdrawal
或然	probable
或许	perhaps
截夺	intercept
截止日	deadline
截止期限	deadline
截然	sharply
戭	spear
战列舰	battleship
战地	battlefield
战斧	battle-ax
战时	wartime
战无不胜	invincible
战略	strategy
战略性	strategic
战船	warship
战术	tactics
战马	warhorse
战斗者	fighter
战斗舰	battleship
战斗部	warhead
戏剧化	theatrical
戏剧性	dramatic
戏台	stage
戏院	theater
戳个儿	physique
戴奥辛	dioxin
戴安娜王妃	Diana
戴尔	Dell
户外	outdoor
户限	threshold
房客	tenant
房室	room
房山区	Fangshan
房东	landlord
房檐	eaves
所在地	location
所多	Soto
所多玛	Sodom
扁圆	oblate
扁坯	slab
扁形动物	flatworm
扁桃腺	tonsil
扁桃腺炎	tonsillitis
扁桃体	tonsil
扁桃体炎	tonsillitis
扁舟	skiff
扁虫	flatworm
扆	screen
扈	retinue
手倒立	handstand
手册	manual
手刹	handbrake
手刹车	handbrake
手势	gesture
手包	handbag
手写体	cursive
手工业	handicraft
手工台	workbench
手式	gesture
手忙脚乱	flustered
手把	handle
手抓饼	fluffy
手拉车	cart
手掌	palm
手提	portable
手提箱	suitcase
手摇	hand-cranked
手肘	elbow
手腕子	wrist
手自一体	manumatic
手举牌	placard
手足无措	bewildered
手锯	handsaw
手镯	bracelet
手闸	handbrake
手雷	grenade
手风琴	accordion
才艺	talent
才艺技能	talent
扎伊尔	Zaire
扒手	pickpocket
扒钉	cramp
打千	genuflection
打印机	printer
打字员	typist
打字机	typewriter
打工人	worker
打底裤	leggings
打戏	opera
打火石	flint
打紧	important
托儿	childcare
托儿	tout
托儿所	nursery
托勒密王	Ptolemy
托尼老师	hairdresser
托架	bracket
托尔斯港	Tórshavn
托皮卡	Topeka
托育	childcare
托莱多	Toledo
托叶	stipule
扢	sprightful
扯裂	rip
扶他林	voltaren
扶南	Funan
扶手椅	armchair
扶桑	Fusang
扶栏	handrail
批评家	critic
承包人	contractor
承包商	contractor
承销店	dealership
技	skill
技术官僚	technocrat
把	handle
把子	handle
把拔	daddy
抑制作用	inhibition
抑扬格	iambic
抑郁	depressed
抓力	grip
抓地力	traction
抓大放小	PRC
抓饼	fluffy
抓马	dramatic
投光灯	floodlight
投影仪	projector
投影机	projector
投机者	speculator
投票者	voter
投资人	investor
投资家	investor
投资者	investor
抖音	Douyin
抗倾覆	anticapsizing
抗凝血剂	anticoagulant
抗原决定簇	epitope
抗忧郁药	antidepressant
抗抑郁药	antidepressant
抗毒素	antitoxins
抗氧化剂	antioxidant
抗生素	antibiotic
抗病毒	antiviral
抗病毒药	antivirals
抗癌	anti-cancer
抗直	unyielding
抗组织胺	antihistamine
抗组胺剂	antihistamine
抗组胺药	antihistamine
抗菌	antibacterial
抗菌素	antibiotic
抗菌药	antibacterial
抗血清	antiserum
抗议者	protester
抗锯齿	anti-aliasing
折光	refraction
折扣	discount
折皱	fold
折旧	depreciation
折衷主义	eclecticism
折头	discount
披巾	shawl
押沙龙	Absalom
抽屉	drawer
抽斗	drawer
抽样	sample
抽脂	liposuction
抽认卡	flashcard
拂扫	whisk
拇囊炎	bunion
拇指甲	thumbnail
拇趾外翻	bunion
拉丁化	romanization
拉克替醇	lactitol
拉包尔	Rabaul
拉夫堡	Loughborough
拉奎拉	L'Aquila
拉姆安拉	Ramallah
拉巴特	Rabat
拉拉	Lala
拉斐尔	Raphael
拉斐特	Lafayette
拉法兰	Raffarin
拉法赫	Rafah
拉管	trombone
拉脱维亚	Latvia
拉达克	Ladakh
拉锁	zipper
拉链	zipper
拉风	trendy
拊	pat
抛射物	projectile
抛射体	projectile
抛物线	parabola
抛体	projectile
拍档	partner
拓展坞	dock
拔染	discharge
拔示巴	Bathsheba
拖布	mop
拖延症	procrastination
拖把	mop
拖曳伞	parasail
拖曳机	tractor
拖沓	dilatory
拖轮	tugboat
拗	contrary
拗	stubborn
拗口	awkward-sounding
拘役	detention
拘束衣	straightjacket
拙劣	clumsy
招待所	guesthouse
招聘者	recruiter
招股说明书	prospectus
拜物教	fetishism
括弧	parentheses
括毒	spiteful
括约肌	sphincter
括号	parentheses
拱度	camber
拱形	arch
拱道	archway
拱点	apse
拳手	boxer
拳拳	sincere
拳击	boxing
拳击手	boxer
拳击选手	boxer
拼多多	Pinduoduo
拼法	spelling
拿不准	indecisive
拿索	Nassau
拿骚	Nassau
持份者	stakeholder
持卡人	cardholder
持有人	holder
持续时间	duration
指北	guide
指北针	compass
指南针	compass
指导者	coach
指尖	fingertip
指挥官	commander
指挥棒	baton
指甲	fingernail
指甲盖	fingernail
指示剂	indicator
指示器	indicator
指示符	indicator
指关节	knuckle
按手礼	ordination
按摩师	masseur
按摩棒	vibrator
按摩浴缸	jacuzzi
按时间先后	chronological
按理	normally
按立	ordination
按说	ordinarily
挌	fight
挎斗	sidecar
挑夫	porter
挑战者	challenger
挑檐	eaves
挑衅	provocation
挖掘机	excavator
挖机	excavator
挖泥船	dredger
挨着	near
挪亚	Noah
挪威	Norway
挫折感	frustration
振幅	amplitude
振荡器	oscillator
挽具	harness
捆缚	bondage
捉摸不定	elusive
捐税	tax
捐赠者	donor
捕手	catcher
捕禽人	birdcatcher
捕头	constable
捕食者	predator
捕鲸船	whaler
捕鸟蛛	tarantula
捕鼠器	mousetrap
捘	push
卷带	tape
卷须	tendril
捷径	shortcut
捷尔任斯克	Dzerzhinsk
掀天揭地	earth-shattering
掀背车	hatchback
扫帚	broom
扫把	broom
扫描器	scanner
扫雪车	snowplow
扫雷艇	minesweeper
扫雷舰	minesweeper
授精	insemination
掌故	anecdote
掌柜	shopkeeper
掎	drag
排枪	salvo
排水渠	drainage
排水沟	gutter
排水量	displacement
排污管	sewer
排泄物	excreta
排湾族	Paiwan
排版	typesetting
排犹主义	antisemitism
排箫	panpipes
掘土机	excavator
挂坠盒	locket
挂毯	tapestry
挂碍	worry
挂绳	lanyard
挂车	trailer
挂锁	padlock
采场	slope
采暖	heating
采样	sampling
采矿	mining
采矿业	mining
采花贼	rapist
采购商	buyer
探测器	detector
探照灯	searchlight
探究式	exploratory
探索性	exploratory
探路者	Pathfinder
探针	probe
探险家	explorer
探险者	explorer
接力	relay
接合菌纲	Zygomycetes
接待员	receptionist
接收器	receiver
接棒人	successor
接班人	successor
接生婆	midwife
接触器	contactor
接连不断	continuous
控制杆	joystick
推力	impetus
推土机	bulldozer
推斥	repulsion
推理小说	whodunit
掩样法	illusion
掩蔽	shelter
措置裕如	effortless
措辞强硬	strongly-worded
掾	official
揃	shear
提供者	supplier
提克里特	Tikrit
提告人	plaintiff
提喻法	synecdoche
提字器	teleprompter
提心	worry
提心吊胆	fearful
提摩太	Timothy
提案人	proposer
提示音	beep
提线木偶	marionette
提词器	teleprompter
提醒物	reminder
插入语	interjection
插图	illustration
插槽	slot
插画	illustration
插头	plug
扬名四海	world-famous
扬抑格	trochaic
扬声器	speaker
换喻	metonymy
揪心揪肺	heart-wrenching
揵	carry
损耗品	consumables
搓衣板	washboard
摇光	Alkaid
摇杆	joystick
摇篮曲	lullaby
摇号	lottery
捣蛋鬼	troublemaker
搜狐	Sohu
搜狐网	Sohu
搜狗	Sogou
搪瓷	enamel
搬运工	porter
抢劫罪	robbery
抢眼	eye-catching
摁扣儿	popper
摁钉儿	thumbtack
摩亨佐·达罗	Moenjo-daro
摩加迪休	Mogadishu
摩加迪沙	Mogadishu
摩尼教	Manichaeism
摩德纳	Modena
摩托罗拉	Motorola
摩托艇	motorboat
摩揭陀	Magadha
摩擦力	friction
摩洛哥	Morocco
摩尔多瓦	Moldova
摩纳哥	Monaco
摩羯座	Capricornus
摩萨德	Mossad
摩西	Moses
挚	sincere
挚诚	sincere
折光	refraction
折纸	origami
撇去	skim
撇号	apostrophe
撑杆跳	pole-vaulting
撑杆跳高	pole-vaulting
撒丁岛	Sardinia
撒哈拉	Sahara
撒哈拉以南	sub-Saharan
撒哈拉威	Sahrawi
撒拉语	Salar
撒然	sudden
撒都该人	Sadducees
撒马利亚	Samaria
撒马尔干	Samarkand
撒马尔罕	Samarkand
撞锁	lock
拨奏	pizzicato
拨子	plectrum
拨火棍	poker
拨片	plectrum
拨用	appropriation
抚抱	caress
撬棍	crowbar
撬棒	crowbar
撬杠	crowbar
播报员	announcer
播放列表	playlist
撼天动地	earth-shaking
捡骨	bone-gathering
擂茶	"leicha"
擅断	arbitrary
击球员	baseball
挡泥板	mudguard
操作员	operator
操作者	operator
操舵室	pilothouse
担架床	stretcher
担惊受怕	alarmed
擖	scrape
据此	accordingly
据说	reportedly
挤踏	stampede
擦鞋垫	doormat
擦音	fricative
拟声	onomatopoeia
拟声词	onomatopoeia
拟卤素	pseudohalogen
擭	trap
拧	stubborn
搁板	shelf
搁脚板	footrest
搁脚物	footrest
摆子	malaria
摆渡	ferry
摆线	cycloid
攃	preceding
拢共	altogether
拢总	altogether
摄影家	photographer
摄影师	photographer
摄影术	photography
摄影记者	photojournalist
摄政王	regent
支付宝	Alipay
支光	watt
支座	abutment
支持者	supporter
支撑架	bracket
支族	subfamily
支气管炎	bronchitis
支系统	subsystem
支部	branch
收件箱	inbox
收割者	reaper
收容人	inmate
收成	harvest
收条	receipt
收生婆	midwife
收货人	consignee
收费站	tollbooth
收银员	cashier
改革家	reformer
改革者	reformer
放任政策	non-interference
放大器	amplifier
放射免疫测定	radioimmunoassay
放射学	radiology
放射性	radioactive
放射性活度	radioactivity
放射治疗	radiotherapy
放射疗法	radiotherapy
放屁虫	stinkbug
放松管制	deregulation
放浪不羁	dissolute
放荡不羁	dissolute
放诞不拘	dissolute
放诞不羁	dissolute
政事	politics
政客	politician
政治局	politburo
政治性	political
敃	strong
故事	narrative
故事线	storyline
故意	deliberately
故此	therefore
故而	therefore
效率	efficiency
敉	peaceful
敏锐	keen
救世	salvation
救主	savior
救兵	reinforcements
救恩	salvation
救星	savior
救生员	lifeguard
救生船	lifeboat
救生艇	lifeboat
救赎主	Redeemer
败家子	spendthrift
败兴	disappointed
败血症	septicaemia
叙事	narrative
叙事线	storyline
叙利亚	Syria
叙述性	narrative
教仪	ordinance
教务长	provost
教堂墓地	churchyard
教学法	pedagogy
教宗	pope
教宗座驾	popemobile
教本	textbook
教条主义	dogmatism
教母	godmother
教派	sect
教父	godfather
教皇	pontiff
教众	followers
教科文组织	UNESCO
教育学	pedagogy
教育家	educationalist
教育工作者	educator
敞开儿	unrestrictedly
敢达	Gundam
散光	astigmatism
散弹枪	shotgun
散职	sinecure
散话	digression
散逸层	exosphere
散饵	groundbait
敦刻尔克	Dunkirk
敦豪	DHL
敬意	respect
敬虔	devout
敲诈罪	extortion
整密	meticulous
整脊学	chiropractic
敌基督	Antichrist
敌意	enmity
敌方	enemy
数	repeatedly
数不胜数	innumerable
数不清	countless
数不尽	countless
数字命理学	numerology
数学	mathematics
数学公式	formula
数学家	mathematician
数得着	notable
数据	data
数据手册	datasheet
数据组	dataset
数据集	dataset
数码港	Cyberport
数词	numeral
文人	scholar
文具商	stationer
文员	clerk
文字学	philology
文凭	diploma
文戏	opera
文抄公	plagiarist
文旦	pomelo
文明化	civilize
文档	document
文殊	Manjushri
文殊师利菩萨	Manjushri
文殊菩萨	Manjushri
文法	grammar
文盲	illiterate
文秘	secretary
文胸	bra
文莱	Brunei
斐济	Fiji
斐理伯	Philip
斑斓	gorgeous
斑疹伤寒	typhus
斑痕	stain
斑马鱼	zebrafish
斑驳陆离	variegated
斑鸠	turtledove
斗大	huge
料件子活	piecework
料子	material
料理店	restaurant
斜率	slope
斜体字	italics
斧	hatchet
斨	axe
斯堪的纳维亚	Scandinavia
斯多葛主义	Stoicism
斯大林主义	Stalinism
斯巴达	Sparta
斯巴鲁	Subaru
斯德哥尔摩	Stockholm
斯拉夫	Slavic
斯普林菲尔德	Springfield
斯普特尼克	Sputnik
斯柯达	Škoda
斯洛文尼亚	Slovenia
斯特拉斯堡	Strasbourg
斯瓦希里	Swahili
斯科普里	Skopje
斯雷布雷尼察	Srebrenica
新冠肺炎	COVID-19
新加坡	Singapore
新古典	neoclassical
新古典主义	neoclassicism
新奇	novel
新娘	bride
新嫁娘	bride
新字体	shinjitai
新宿	Shinjuku
新教	Protestantism
新殖民主义	neocolonialism
新殖民化	neocolonialization
新浪	Sina
新浪网	Sina
新潟	Niigata
新石器	Neolithic
新竹市	Hsinchu
新义州市	Shin'ŭiju
新闻学	journalism
新闻工作者	journalist
新闻发言人	spokesman
新闻组	newsgroup
新闻记者	journalist
新艺拉玛	Cinerama
新艺综合体	CinemaScope
新西伯利亚市	Novosibirsk
新词	neologism
新近	newly
新郎	bridegroom
新郎倌	bridegroom
新郎官	bridegroom
断乎	certainly
断崖式	precipitous
断续	intermittent
𣃁	cut
方位角	azimuth
方尖碑	obelisk
方帽	mortarboard
方方正正	square-shaped
方法学	methodology
方舟	ark
方铅矿	galena
方头巾	headscarf
于是	thereupon
于是乎	therefore
施事	doer
施事者	doer
施政	administration
施教	teaching
施乐	Xerox
施洗	baptize
施虐受虐	sado-masochism
旁边	side
旅客	traveler
旅程表	itinerary
旅舍	inn
旅行者	traveler
旅途	journey
旋律	melody
旋渊	abyss
旋涡状	spiral-shaped
旋花科	Convolvulaceae
旐	banner
旒	tassel
旖旎	enchanting
旗杆	flagpole
旗标	flag
旗舰	flagship
旗袍	cheongsam
旗语	semaphore
旛	pennant
既已	already
既有	existing
既然	since
日中	Japan-China
日光	sunlight
日光浴	sunbathing
日光浴浴床	sunbed
日内瓦	Geneva
日冕	corona
日出	sunrise
日常	day-to-day
日常工作	routine
日晷	sundial
日暮	sunset
日晒伤	sunburn
日月五星	sun
日本	Japan
日本共同社	Kyōdō
日本学	Japanology
日照	sunshine
日立	Hitachi
日美	Japan-US
日耳曼	Germanic
日规	sundial
日间	daytime
旦角	dan
旨趣	objective
早前	previously
早午饭	brunch
早午餐	brunch
早场	matinee
早搏	extrasystole
早熟	precocious
早老素	presenilins
早点	breakfast
旱	drought
旱灾	drought
旱獭	marmot
旱象	drought
旱鸭子	non-swimmer
旴	dawn
旺炽	blazing
旻	heaven
昂撒	Anglo-Saxon
昆布	kelp
昆虫学	entomology
升平	peaceful
昌	flourishing
昌平区	Changping
昌明	flourishing
昌盛	prosperous
昌迪加尔	Chandighar
明信片	postcard
明光度	luminosity
明喻	simile
明天	tomorrow
明尼苏达	Minnesota
明尼苏达州	Minnesota
明尼阿波利斯	Minneapolis
明教	Manichaeism
明斯克	Minsk
明日	tomorrow
明星	star
明晰	clear
明治	Meiji
明沟	ditch
明矾	alum
明胶	gelatin
明虾	prawn
明达	reasonable
明里	publicly
昏庸	muddleheaded
昏暗	dusky
昏聩	muddle-headed
昑	bright
易取得	accessible
易弯	flexible
易感	susceptible
易接近	accessible
易挥发	volatile
易损性	vulnerability
易洛魁	Iroquois
易溶	soluble
易激惹	irritable
易爆	explosive
易腐败	perishable
易变质	perishable
易趣	EachNet
易游网	ezTravel
易饥症	bulimia
昕	dawn
星光	starlight
星冰乐	Frappuccino
星巴克	Starbucks
星斗	stars
星期一	Monday
星期三	Wednesday
星期二	Tuesday
星期五	Friday
星期六	Saturday
星期四	Thursday
星期天	Sunday
星期日	Sunday
星洲	Singapore
星相学	astrology
星相家	astrologer
星相师	astrologer
星相术	astrology
星术	astrology
星辰	stars
星云	nebula
星驰	rapidly
昤	sunshine
春妇	prostitute
春季	springtime
春日部	Kasukabe
春药	aphrodisiac
春黄菊属	Anthemis
昨	yesterday
昨天	yesterday
昨日	yesterday
昵比	intimate
时代	Time
时代曲	shidaiqu
时令	season
时常	often
时延	latency
时戳	timestamp
时机	opportunity
时节	season
时而	occasionally
时钟	clock
时长	duration
时间戳	timestamp
时间测定学	chronometry
时间线	timeline
晌午	noon
晚世	nowadays
晚晌	evening
昼	daytime
昼行性	diurnality
晢	bright
普世	universal
普列谢茨克	Plesetsk
普利托里亚	Pretoria
普利茅斯	Plymouth
普契尼	Puccini
普惠	inclusive
普拉亚	Praia
普林斯顿	Princeton
普罗夫迪夫	Plovdiv
普罗米修斯	Prometheus
普罗维登斯	Providence
普贤	Samantabhadra
普贤菩萨	Samantabhadra
普适	universal
普雷克斯流程	purex
普雷斯顿	Preston
普鲁东主义	Proudhonism
景气	prosperous
景况	circumstances
景物	scenery
景致	view
景色	scenery
景观	landscape
晶	crystal
晶亮	bright
晶状	crystalline
晶闸管	thyristor
晶体	crystal
晶体管	transistor
晷	sundial
智	wisdom
智利	Chile
智性恋	sapiosexuality
智慧	wisdom
智神星	Pallas
智能手机	smartphone
智能手表	smartwatch
智谋	resourcefulness
晾衣绳	clothesline
暇	leisure
晕头	dizzy
暌隔	parted
暍	hot
暖化	warming
暖意	warmth
暖瓶	thermos
暗喻	metaphor
暗地	secretly
暗地里	secretly
暗堡	bunker
暗室	darkroom
暗影	shadow
暗流	undercurrent
暗沟	sewer
暗潮	undercurrent
暗疮	acne
暗里	privately
暗黑	dark
暝	dark
畅快	carefree
畅然	happily
畅通	unobstructed
暪	dark
暂且	temporarily
暂态	transient
暂时	temporary
暂行	provisional
暮色	twilight
暴光	exposure
暴戾	ruthless
暴戾恣睢	ruthless
暴牙	bucktooth
暴虐无道	oppressive
暴躁	irascible
暴露狂	exhibitionist
暴露癖	exhibitionism
暴食症	bulimia
暴龙科	Tyrannosauridae
暹	sunrise
暻	bright
历	calendar
历书	almanac
旷野	wilderness
旷阔	vast
晒娃	sharenting
晒衣绳	clothesline
曲度	curvature
曲线锯	jigsaw
曲轴	crankshaft
曲霉毒素	aspergillus
书刊	publications
书写不能症	agraphia
书挡	bookend
书札	letter
书档	bookend
书柜	bookcase
书橱	bookcase
书法家	calligrapher
书立	bookend
书箧	bookcase
书虫	bookworm
书记处	secretariat
书面	written
曼妥思	Mentos
曼尼托巴	Manitoba
曼德勒	Mandalay
曼彻斯特	Manchester
曼海姆	Mannheim
曼谷	Bangkok
曾孙	great-grandson
曾孙女	great-granddaughter
曾祖父母	great-grandparents
替罪羊	scapegoat
替罪羔羊	scapegoat
最低点	nadir
最佳化	computing
最喜爱	favorite
最年长	eldest
最后通牒	ultimatum
最终	final
朁	if
会厌	epiglottis
会厌炎	epiglottitis
会合处	joint
会员	member
会客室	parlor
会客厅	parlor
会死	mortal
会漏	leak
会计师	accountant
会计科目	account
月亮女神号	SELENE
月份	month
月光	moonlight
月光石	moonstone
月子	puerperium
月度	monthly
月牙形	crescent
月琴	yueqin
月经棉栓	tampon
月色	moonlight
月华	moonlight
有一拼	comparable
有一点	somewhat
有人情	humane
有价值	valuable
有利	advantageous
有利可图	profitable
有创造力	ingenious
有味	tasty
有型	stylish
有夏	China
有孔虫	foraminifera
有帮助	helpful
有幸	fortunately
有弹性	flexible
有影响	influential
有德行	virtuous
有志气	ambitious
有恒	perseverance
有情人	lovers
有意识	conscious
有才干	capable
有排面	showy
有攻击性	offensive
有效性	validity
有效负载	payload
有料	impressive
有时候	sometimes
有条纹	striped
有机	organic
有机玻璃	plexiglass
有机磷酸酯类	organophosphate
有机体	organism
有权威	authoritative
有次	once
有次序	ordered
有毒	poisonous
有气派	lordly
有气无力	dispirited
有气质	classy
有氧健身操	aerobics
有氧操	aerobics
有氧运动	aerobics
有决心	determined
有用	useful
有界	bounded
有益处	beneficial
有节	segmented
有精神病	insane
有丝分裂	mitosis
有罪	guilty
有罪不罚	impunity
有耐久力	durable
有声书	audiobook
有能力	able
有胆量	courageous
有良心	conscientious
有色眼镜	prejudice
有卖相	appealing
有轨电车	streetcar
有道理	reasonable
有阴影	shadowy
有雄心	ambitious
有预谋	premeditated
有风	windy
朊	protein
朋	friend
朋党	clique
朝	morning
朝圣者	pilgrim
朝着	towards
期刊	periodical
木偶	puppet
木刻	woodcut
木匠	carpenter
木卡姆	muqam
木吒	Muzha
木块	block
木材	wood
木柴	firewood
木桶	cask
木炭	charcoal
木然	stupefied
木版画	woodcut
木犀	osmanthus
木琴	xylophone
木瓦	shingle
木糖醇	xylitol
木糠	sawdust
木聚糖	xylan
木莓	raspberry
木薯	cassava
木薯淀粉	tapioca
木兰属	Magnolia
木兰科	Magnoliaceae
木兰花	magnolia
木虱	woodlouse
木制	wooden
木质	wooden
木质素	lignin
木质部	xylem
木钉	peg
未卜	unknowable
未可	cannot
未尝不可	fine
未婚	unmarried
未婚夫	fiancé
未婚妻	fiancée
未定	undecided
未成	incomplete
未成年	underage
未熟	unripe
未知	unknown
未经证实	unconfirmed
末尾	end
末后	finally
末日论	eschatology
末端	tip
本尼迪	Benedictus
本州	Honshū
本底	background
本影	umbra
本日	today
本能	instinct
本那比市	Burnaby
本体论	ontology
札幌	Sapporo
札格雷布	Zagreb
朱	vermilion
朱红	vermilion
朱迪亚	Judea
朳	tree
朽	rotten
朽坏	rotten
朽烂	rotten
朿	stab
杆子	pole
李	plum
李木	blackthorn
李氏朝鲜	Joseon
杏仁核	amygdala
杏仁体	amygdala
杏子	apricot
杏眼	large
村子	village
村民	villager
村舍	cottage
村落	village
杓子	scoop
杜哈	Doha
杜尚别	Dushanbe
杜松子酒	gin
杜笃玛	Dodoma
杜蕾斯	Durex
杜马	Duma
杝	tree
束腰	girdle
束身内衣	corset
东仓里	Dongchang-ni
东加	Tonga
东北	Manchuria
东北	northeast
东南	southeast
东城区	Dongcheng
东床	son-in-law
东方	east
东方阿閦佛	Aksobhya
东洋鬼	Nip
东洋鬼子	Nip
东芝	Toshiba
东道	host
杳无人迹	uninhabited
杶	tree
杻	handcuffs
松巴哇	Sumbawa
松巴哇岛	Sumbawa
松科	pinaceae
松节油	turpentine
松鸡	grouse
松露	truffle
松鹤遐龄	longevity
松鼠	squirrel
板岩	slate
板板	solemn
板条	lath
板条箱	crate
板状	board-shaped
板皮	slab
板车	handcart
板门店	Panmunjeom
枌	tree
枕套	pillowcase
枕边人	partner
枕头	pillow
林务	forestry
林可霉素	lincomycin
林地	woodland
林学	forestry
林荫道	boulevard
林雪平	Linköping
果仁密饼	baklava
果倍爽	Capri-Sun
果品	fruit
果园	orchard
果子冻	jelly
果敢	courageous
果糖	fructose
果肉	pulp
果胶	pectin
果若	if
果酱	jam
果馅饼	tart
枯干	shriveled
枯寂	bleak
枯燥	uninteresting
枯萎病	blight
柈	plate
柏拉图哲学	Platonism
柏林	Berlin
某些	some
某时	sometime
某物	something
某处	somewhere
柑橘	citrus
柑橘酱	marmalade
染料	dye
染毒	contamination
染色	dye
染色体	chromosome
染色体三倍体症	trisomy
柔性	flexibility
柔情脉脉	tender-hearted
柔软	soft
柔道	judo
柘榴	pomegranate
柘榴石	garnet
柣	threshold
查克瑞	chakra
查尔斯	Charles
查尔斯顿	Charleston
查韦斯	Chavez
柩	bier
柬埔寨	Cambodia
柯夫塔	kofta
柯尼斯堡	Königsberg
柯沙奇病毒	Coxsackievirus
柯那克里	Conakry
柱梁	pillar
柱石	pillar
柳	willow
柳啼花怨	desolate
柳杞	willow
柳条	osier
柳树	willow
柳眉	long
柳陌花衢	brothel
柴草	firewood
柴薪	firewood
栅栏	fence
柿	persimmon
栓剂	suppository
栓皮	cork
栗	chestnut
栗子	chestnut
校区	campus
校园	campus
校订	revision
栩栩	vivid
栩栩生辉	resplendent
栱	post
栲属	Castanopsis
栲胶	tannin
栳	basket
栴檀	sandalwood
栵	hedge
核合成	nucleosynthesis
核小体	nucleosome
核心	core
核糖	ribose
核糖体	ribosome
核苷	nucleoside
核苷酸	nucleotide
核碱基	nucleobase
根基	foundation
根特	Ghent
根茬	stubble
根须	roots
栻	tree
格但斯克	Gdansk
格子呢	plaid
格子棉布	gingham
格子花呢	tartan
格子间	cubicle
格拉斯哥	Glasgow
格拉纳达	Granada
格林多	Corinthians
格林威治	Greenwich
格林威治村	Greenwich
格林纳达	Grenada
格栅	grille
格格笑	giggle
格瑞那达	Grenada
格罗宁根	Groningen
格罗兹尼	Grozny
格言	maxim
格陵兰	Greenland
格陵兰岛	Greenland
桀贪骜诈	brutal
桃	peach
桃子	peach
桃红	pink
桃花心木	mahogany
桅	mast
桅杆	mast
案文	text
桉树	eucalyptus
桋	tree
桌上型	desktop
桌巾	tablecloth
桌案	table
桎	fetters
桑给巴尔	Zanzibar
桑蚕	silkworm
桲	flail
桶孔	bunghole
桹	palm
梁赞	Ryazan
梁龙	diplodocus
梅子	plum
梅林	Merlin
梅毒	syphilis
梐	stockade
梗概	gist
条件式	conditional
条例	regulations
条凳	bench
条形码	barcode
条板箱	crate
条码	barcode
条纹	stripe
条规	rule
梧桐科	Sterculiaceae
梨俱吠陀	Rigveda
梨属	Pyrus
梨果	pome
梭子鱼	barracuda
梭镖	spear
梭鱼	barracuda
梯	stairs
梯度	gradient
梯板	gangplank
梵教	Brahmanism
梵文	Sanskrit
梵书	Brahmana
棉花	cotton
棋盘	chessboard
棍子	stick
棍杖	staff
棍棒	club
棍网球	lacrosse
棒冰	popsicle
棕色	brown
棘	thorns
棘皮动物	echinoderm
棘轮	ratchet
棚户区	shantytown
棠	cherry-apple
栈主	innkeeper
栈板	pallet
栈架	trestle
栈豆	fodder
棪	tree
棬	bowl
森美兰	Sembilan
栖地	habitat
栖息地	habitat
栖栖	unsettled
栖栖遑遑	unsettled
棺	coffin
棺木	coffin
椅	chair
植树造林	afforestation
植物化学成分	phytochemical
植物学	botany
植物学家	botanist
植物牛油	margarine
植物群	flora
椎骨	vertebra
椒	pepper
椓	beat
椪柑	ponkan
椰菜	cabbage
椵	grapefruit
椸	clothes-horse
椿象	stinkbug
杨	poplar
楎	clothes-horse
枫木	maple
枫树	maple
楔形物	wedge
楛	tree
楟	tree
楩	tree
业务员	salesperson
业已	already
业界	industry
业经	already
业余爱好者	hobbyist
业余者	amateur
楮纸	kozogami
楰	tree
极其	extremely
极化	polarization
极度	extremely
极权	totalitarian
极权主义	totalitarianism
极为	extremely
极端	extreme
极端主义	extremism
极端分子	extremist
极简主义	minimalism
极道	yakuza
楹	pillar
概念化	conceptualization
概括化	generalization
概要	outline
概述	overview
榆	elm
榆树	elm
榕树	banyan
榛子	hazelnut
榛实	hazelnut
榛栗	hazelnut
榛色	filbert
榜样	model
榥	screen
榨酒池	winepress
杩	headboard
榭	pavilion
荣光	glory
荣市	Vinh
荣美	glorious
荣耀	honor
荣誉国民	veteran
榴	pomegranate
榴弹炮	howitzer
榻	couch
桤	alder
桤木	alder
构架	structure
槌球	croquet
枪刺	bayonet
枪子	bullet
枪弹	bullet
枪械	firearm
枪法	marksmanship
枪乌贼	squid
枪炮	firearm
杠杠的	great
杠铃	barbell
槥	coffin
槭树	maple
槲寄生	mistletoe
桨手	rower
槽位	slot
槾	tree
乐	music
乐事	pleasure
乐园	paradise
乐土	paradise
乐学者	musicologist
乐师	musician
乐感	musicality
乐蜀	Luxor
乐观	optimistic
乐观主义	optimism
乐购	Tesco
乐趣	delight
乐颠了馅	ecstatic
乐高	Lego
枞树	fir
樎	manger
楼下	downstairs
楼宇	building
楼层	floor
楼厢	loft
楼面	floor
樕	shrub
樗	simaroubaceae
标度	scale
标枪	javelin
标准化	standardization
标准尺寸	gauge
标牌	label
标致	pretty
标号	grade
标志性	iconic
标语牌	placard
枢垣	censorate
枢轴	pivot
樟宜	Changi
模仿品	counterfeit
模块化	modularity
模块式	modular
模式	mode
模形	pattern
模拟器	emulator
样例	sample
样品	sample
样本	sample
样机	prototype
样貌	appearance
樵子	woodcutter
朴实无华	plain
朴次茅斯	Portsmouth
树上熟	tree-ripe
树冠	treetop
树木	tree
树梢	treetop
树熟	tree-ripe
树篱	hedge
树脂	resin
树苗	sapling
树菠萝	jackfruit
树葡萄	jaboticaba
树袋熊	koala
桦木	birch
桦树	birch
椫	wood
桥镇	Bridgetown
橘皮组织	cellulite
橙子	orange
机制	mechanism
机动性	flexibility
机器人	robot
机器人学	robotics
机密性	confidentiality
机敏	agility
机械工人	mechanic
机械性	mechanical
机壳	case
机理	mechanism
机能	function
机制	machine-processed
机要	classified
机诈	deceitful
机遇	opportunity
机长	captain
机关车	locomotive
橡子	acorn
橡实	acorn
橡木	oaken
橡树	oak
橡胶	rubber
椭	ellipse
椭圆形	oval
横截面	cross-section
横梁	beam
横楣	lintel
横楣子	lintel
横滨	Yokohama
横筋斗	cartwheel
横纲	yokozuna
横肉	fierce-looking
横膈	diaphragm
横竖	anyway
横队	rank
檀君	Tangun
檀君王	Tangun
檀香	sandalwood
柽	tamarisk
檐廊	veranda
档案	file
档案夹	portfolio
档案袋	portfolio
檖	tree
检查员	inspector
检查站	checkpoint
检测器	detector
检疫	quarantine
检眼镜	ophthalmoscope
檨	mango
台	desk
台布	tablecloth
檴	tree
柠檬	lemon
柠檬水	lemonade
槛花笼鹤	prisoner
柜员	teller
柜员机	ATM
櫌	harrow
榉木	beech
棂	latticework
樱	cherry
樱岛	Sakurajima
樱桃	cherry
樱花草	primrose
欂	rafter
栏位	numeric
栏架	hurdle
栏栅	barrier
权宜	expedient
权杖	scepter
权柄	authority
权能	power
𪲔	beam
𪴙	gather
欙	sedan
次序	sequence
次文化	subculture
次方言	subdialect
次等	second-class
次级	secondary
次要	secondary
欣	happy
欣喜	happy
欲念	desire
欸	eh
欹	interjection
欺诈者	deceiver
欼	drink
歈	songs
歌儿	song
歌利亚	Goliath
歌后	diva
歌唱家	singer
歌子	song
歌手	singer
歌曲	song
歌罗西	Colossia
歌舞伎	kabuki
欧亚大陆	Eurasia
欧元区	Eurozone
欧柏林	Oberlin
欧若拉	Aurora
欧蝶鱼	plaice
欢忭	delighted
欢欣	elated
欢欣鼓舞	overjoyed
欢欢喜喜	happily
止汗剂	anti-perspirant
止痛片	painkiller
正交	orthogonality
正仓院	Shōsō-in
正型标本	holotype
正字法	orthography
正宫娘娘	empress
正式	formal
正方形	square
正模标本	holotype
正牌	genuine
正畸	orthodontics
正确	correct
正误表	corrigenda
正负号	±
此	this
此外	besides
步法	footwork
步测	pacing
步行者	pedestrian
步话机	walkie-talkie
武器级	weapons-grade
武士刀	katana
武装分子	gunman
歪歪扭扭	crooked
历史学	history
历史学家	historian
历史家	historian
历史性	historic
历史遗产	heritage
归化	naturalization
死尸	corpse
死心塌地	unswerving
死产	stillbirth
死皮赖脸	shameless
死藤水	ayahuasca
死飞	fixie
殃	calamity
殑	swoon
殖民主义	colonialism
殖民地	colony
残暴	brutal
残株	stubble
残次	defective
残毒	cruelty
残障	handicapped
𣨼	fatigue
殓房	morgue
殡仪	funeral
殡仪员	mortician
殡车	hearse
杀人鲸	orca
杀千刀	damn
杀千刀的	bastard
杀婴	infanticide
杀真菌剂	fungicide
杀草快	diquat
杀虫	insecticide
杀虫药	insecticide
壳质	chitin
殿军	runner-up
毁损	impair
母乳喂养	breastfeeding
母国	motherland
母板	motherboard
母权制	matriarchy
母系社会	matrilineality
母细胞	matricyte
母音	vowel
母驴	jenny
每个	each
每夜	nightly
每每	often
每当	whenever
毑	mother
毒力	virulence
毒性	toxicity
毒液	venom
毒物	poison
毒理学	toxicology
毒莠定	picloram
毒药	poison
毒蛇	viper
毓婷	Yuting
比亚	Bia
比亚韦斯托克	Białystok
比什凯克	Bishkek
比值	ratio
比利	HK
比利时	Belgium
比勒陀利亚	Pretoria
比哈尔邦	Bihar
比埃兹巴伯	Beelzebub
比安	Bienne
比率	ratio
比绍	Bissau
比萨	Pisa
毛主义	Maoism
毛利人	Maori
毛刷	brush
毛哔叽	serge
毛孔	pore
毛小囊	follicle
毛毛的	unnerved
毛毛虫	caterpillar
毛毯	blanket
毛毡	felt
毛派	Maoist
毛泽东主义	Maoism
毛细	capillary
毛细孔	pore
毛织运动衫	jersey
毛茛	buttercup
毛茸茸	hairy
毛虫	caterpillar
毛象	mammoth
毛里塔尼亚	Mauritania
毛里求斯	Mauritius
毛发	hair
毛霉菌病	mucormycosis
毫克	milligram
毫升	milliliter
毫安	milliampere
毫瓦	milliwatt
毫秒	millisecond
毫米	millimeter
毷	restless
毹	rug
毽	shuttlecock
氅	overcoat
毡房	yurt
氉	restless
氏族	clan
民主主义者	democrat
民俗学	folklore
民族志	ethnography
民族自决	self-determination
民营化	privatization
民粹主义	populism
氘核	deuteron
氛围	ambience
氟化物	fluoride
气不公	indignant
气候学	climatology
气凝胶	aerogel
气动	pneumatic
气动式	pneumatic
气味	odor
气喘喘	breathless
气喘病	asthma
气压表	barometer
气压计	barometer
气宇	bearing
气密	airtight
气旋	cyclone
气氛	atmosphere
气冲冲	furious
气冲牛斗	infuriated
气冲霄汉	courageous
气溶胶	aerosol
气焰	arrogance
气球	balloon
气筒	inflator
气胶	aerosol
气色	complexion
气象学	meteorology
气雾剂	aerosol
氤氲	thick
氧乙炔	oxyacetylene
氧化物	oxide
氧合器	oxygenator
氧气	oxygen
氨	ammonia
氨哮素	clenbuterol
氨基甲酸酯类化合物	carbamate
氪气石	kryptonite
氢化	hydrogenation
氢氟烃	hydrofluorocarbon
氢氧	oxyhydrogen
氮气	nitrogen
氯丁橡胶	neoprene
氯化物	chloride
氯化苦	chloropicrin
氯林可霉素	clindamycin
氯气	chlorine
氯洁霉素	clindamycin
氯痤疮	chloracne
氰化物	cyanide
氰基细菌	cyanobacteria
氰酸盐	cyanate
水上飞板	flyboard
水上飞机	seaplane
水凼	pond
水刑逼供	water-boarding
水力学	hydraulics
水力发电	hydroelectricity
水勺	ladle
水印	watermark
水垢	limescale
水培法	hydroponics
水基	water-based
水塘	pool
水彩	watercolor
水患	flooding
水文	hydrology
水晶	crystal
水杉	metasequoia
水桶	bucket
水槽	sink
水渠	canal
水潭	pond
水獭	otter
水产业	aquaculture
水产养殖	aquaculture
水田芥	watercress
水疱	blister
水盆	basin
水磨石	terrazzo
水禽	waterfowl
水洼	puddle
水管工	plumber
水管工人	plumber
水纹	ripples
水翼船	hydrofoil
水耕法	hydroponics
水肺	scuba
水蒸气	vapor
水蛭	leech
水蛭素	hirudin
水行侠	Aquaman
水豚	capybara
水路	waterway
水银	mercury
水雾	mist
水鸟	waterbird
永久冻土	permafrost
永久性	permanent
永冻土	permafrost
永定门	Yongdingmen
永无止境	never-ending
永珍	Vientiane
永矢	forever
永诀式	funeral
氹仔	Taipa
汁	juice
汁液	juice
汔	near
汗津津	sweaty
汗液	sweat
汗褂儿	undershirt
汝	thou
汞齐	amalgam
江河	river
江湖医生	quack
江畔	riverbank
污垢	dirt
污染物	pollutant
污水	sewage
污水坑	cesspit
污渍	stain
污痕	blot
污言秽语	obscenities
污迹	blotch
汫𣸨	meandering
汭	river-bend
决定论	determinism
决策者	policymaker
汽油	gasoline
汽碾	steamroller
汽车旅馆	motel
沃尔夫	Wolf
沃尔夫斯堡	Wolfsburg
沃尔玛	Wal-Mart
沃尔芬森	Wolfson
沃罗涅日	Voronezh
沉浸式	immersive
沉淀物	precipitate
沉甸甸	heavy
沉积物	sediment
沉郁	melancholy
没	not
没人住	unoccupied
没有品味	tasteless
没有形状	shapeless
没有止尽	endless
没用	useless
没经验	inexperienced
没羞没臊	shameless
没谁了	extraordinary
冲冲	excitedly
冲绳	Okinawa
沙利度胺	thalidomide
沙加缅度	Sacramento
沙哑	hoarse
沙堡	sandcastle
沙威玛	shawarma
沙岩	sandstone
沙文主义	chauvinism
沙暴	sandstorm
沙棘	sea-buckthorn
沙沙	rustle
沙漠化	desertification
沙琪玛	sachima
沙瓦玛	shawarma
沙眼	trachoma
沙虫	sandworm
沙质	sandy
沙那	Sana'a
沙锤	maraca
沙门氏菌	Salmonella
沙门菌	salmonella
沙鼠	gerbil
沚	islet
河内	Hanoi
河卵石	pebble
河川	rivers
河床	riverbed
河汊	tributary
河涌	tributary
河漫滩	floodplain
河滩	strand
河狸	beaver
河童	kappa
河豚	blowfish
河马	hippopotamus
沴	miasma
沸石	zeolite
油光漆	varnish
油布	tarpaulin
油旋	Youxuan
油桃	nectarine
油油	oily
油炸圈饼	doughnut
油纸	oilpaper
沺	turbulent
治疗师	therapist
治疗法	therapy
治愈系	uplifting
沿海	coastal
况复	moreover
泂	vast
泄泻	diarrhea
泆	licentious
泉路	netherworld
泌乳	lactation
泌尿	urination
泌尿外科	urology
法令	decree
法利赛人	Pharisee
法国	France
法国百合	artichoke
法国长棍	baguette
法塔赫	Fatah
法外	extrajudicial
法定	statutory
法定人数	quorum
法式	French-style
法式	rule
法律责任	liability
法拉	farad
法拉利	Ferrari
法槌	gavel
法王	Sakyamuni
法兰克福	Frankfurt
法兰西	France
法术	magic
法西斯主义	fascism
法警	bailiff
泛光灯	floodlight
泛性恋	pansexuality
泛神论	pantheism
泛自然神论	pandeism
泡沫塑料	styrofoam
泡泡	bubbles
泡泡口香糖	bubble-gum
波来古	Pleiku
波利尼西亚	Polynesia
波动性	fluctuation
波哥大	Bogota
波塞冬	Poseidon
波士顿	Boston
波季	Poti
波幅	amplitude
波德戈里察	Podgorica
波德里查	Podgorica
波恩	Bonn
波提乏	Potiphar
波斯	Persia
波斯尼亚	Bosnia
波斯教	Zoroastrianism
波斯普鲁斯	Bosphorus
波旁	Bourbon
波昂	Bonn
波束	beam
波浪	wave
波尔多	Bordeaux
波特率	baud
波状	wave-shaped
波状云	undulatus
波罗的	Baltic
波美拉尼亚	Pomerania
波茨坦	Potsdam
波兹坦	Potsdam
波兰	Poland
波谱	spectrum
波谷	trough
波长	wavelength
波隆那	Bologna
泥	restrained
泥刀	trowel
泥土	earth
泥敷剂	poultice
泥水匠	mason
泥沙	silt
泥沼	swamp
泥浆	slurry
泥潭	quagmire
泥炭	peat
泥煤	peat
泥质	muddy
泥质页岩	mudstone
泥铲	trowel
注册人	registrant
注射器	syringe
注意力	attention
泫	weep
泰国	Thailand
泰坦巨龙	titanosaur
泰米尔	Tamil
泳衣	swimsuit
泳装	swimsuit
洋灰	cement
洋琵琶	mandolin
洋粉	agar
洋红	carmine
洋罪	torture
洋芫荽	parsley
洋菜	agar
洋车	rickshaw
洋镐	pickaxe
洋香瓜	muskmelon
洋香菜	parsley
洋碱	soap
洗剪吹	shampoo
洗消	decontamination
洗涤桶	washtub
洗洁剂	detergent
洗碗机	dishwasher
洗衣	laundry
洗发乳	shampoo
洗发剂	shampoo
洗发水儿	shampoo
洗发皂	shampoo
洗发精	shampoo
洗发露	shampoo
洚	flood
洛克菲勒	Rockefeller
洛基	Loki
洛锡安区	Lothian
洞孔	hole
洞察力	insight
津岛	Tsushima
津巴布韦	Zimbabwe
津贴	allowance
泄流	drainage
洪亮	resonant
洪堡	Humboldt
洪水	deluge
洪灾	flood
洪都拉斯	Honduras
洪雅族	Hoanya
洲际	intercontinental
活分	nimble
活动人士	activist
活动家	activist
活动挂图	flipchart
活化	activation
活塞	piston
活尸	zombie
活度	activity
活板	trapdoor
活瓣	valve
活组织检查	biopsy
活着	alive
活见鬼	preposterous
活跃分子	activist
活门	valve
活体检视	biopsy
派别	group
派翠西亚	Patricia
流亡政府	government-in-exile
流利	fluent
流感	flu
流星体	meteoroid
流民	refugee
流苏	tassels
流萤	firefly
流行性感冒	influenza
流行病学	epidemiology
流变学	rheology
流变能力	rheology
流量计	flowmeter
流体	fluid
浙赣	Zhejiang-Jiangxi
浚泥船	dredger
浣女	washerwoman
浩大	vast
浩浩荡荡	majestic
浩阔	vast
浪子	loafer
浪漫	romantic
浪漫主义	romanticism
浪船	swingboat
浪莽	vast
浪头	wave
浮世绘	ukiyo-e
浮力	buoyancy
浮岩	pumice
浮标	buoy
浮沫	froth
浮浅	skin-deep
浮游生物	plankton
浮石	pumice
浮肿病	dropsy
浮萍	duckweed
浮着	afloat
浮薄	frivolous
浮质	aerosol
浮点型	float
浮点数	float
浴盆	bathtub
浴缸	bathtub
浴血	blood-soaked
浴袍	bathrobe
海上	maritime
海味	seafood
海员	sailor
海啸	tsunami
海地	Haiti
海外	overseas
海宝	Haibao
海岬	headland
海岱	Haidai
海岸警卫队	coastguard
海岛	island
海峡	strait
海带	kelp
海底	seabed
海底轮	muladhara
海德堡	Heidelberg
海德尔堡	Heidelberg
海榴	pomegranate
海水	seawater
海水养殖	aquaculture
海洋学	oceanography
海洋性	maritime
海洋性贫血	thalassemia
海淀区	Haidian
海潮	tide
海尔德兰	Gelderland
海牛	manatee
海狸	beaver
海狸鼠	nutria
海盗	pirate
海盗行为	piracy
海绵状	spongy
海苔	nori
海草	seagrass
海虹	mussel
海蛎	oyster
海蛎子	oyster
海豚	dolphin
海豚馆	dolphinarium
海象	walrus
海豹科	Phocidae
海贼	pirate
海军	navy
海迪	Heidi
海鲜	seafood
海鸟	seabird
海鸥	gull
浸信会	Baptists
浸礼会	Baptists
涄	watery
消化不良	indigestion
消化酒	digestif
消毒剂	disinfectant
消消停停	intermittently
消费券	voucher
消费级	consumer-grade
消费者	consumer
消防员	firefighter
消防队员	fireman
消音器	silencer
涉黑	gang-related
涎	saliva
涎水	saliva
涎沫	spittle
液滴	droplet
液胞	vacuole
液体	liquid
涵洞	culvert
涵淡	waves
涷	rainstorm
凉亭	pavilion
凉鞋	sandal
淋巴液	lymph
淋巴瘤	lymphoma
淋巴细胞	lymphocyte
凄切	mournful
凄清	somber
淘河	pelican
泪	teardrops
泪滴	teardrop
泪珠	teardrop
淡光	shimmer
淤伤	bruising
淫乱	promiscuous
淫念	lust
淫欲	lust
淫棍	womanizer
淫秽	obscene
淫亵	obscene
深厚	deep
深渊	abyss
深谋	forethought
渊冲	insightful
混乱	confused
混凝剂	coagulant
混合物	mixture
混合现实	MR
混合肥料	compost
混合体	mixture
混名	nickname
混编	mixed
混号	nickname
混血	mixed-race
淹头搭脑	listless
浅析	primary
浅浮雕	bas-relief
浅薄	superficial
浅近	simple
浅显	accessible
添加物	additive
清亮	clear
清教徒	Puritan
清晰	clear
清洁器	cleaner
清澄	limpid
清澈	clear
清莹	limpid
清瘦	meager
清盘	liquidation
清真寺	mosque
清丽	elegant
减法	subtraction
减震器	shock-absorber
渠沟	trench
渠魁	ringleader
渡船	ferry
渤海	Parhae
渥太华	Ottawa
涡喷	turbojet
涡扇	turbofan
涡桨	turboprop
涡轮	turbine
涡轮喷气发动机	turbojet
涡轮轴发动机	turboshaft
测径器	calipers
测谎仪	polygraph
测谎器	polygraph
渴	thirsty
游戏手柄	gamepad
游泳馆	natatorium
渺远	distant
浑家	wife
浑号	nickname
湄	coast
湍流	turbulence
湎	drunk
湖	lake
湖沼学	limnology
湖泊	lake
湖畔	lakeside
湖边	lakeside
湘黔	Hunan-Guizhou
湛蓝	azure
湫	marsh
汤加	Tonga
汤加群岛	Tonga
汤加里罗	Tongariro
汤汁	soup
源源不断	continuous
源头	source
源点	source
准妈妈	mother-to-be
准决赛	semifinal
准确	accurate
准确性	accuracy
准谱儿	certainty
溘	suddenly
溘然	suddenly
沟谷	gully
沟道	groove
溢满	overflowing
溥仪	Puyi
溪流	stream
温乎	warm
温和	lukewarm
温和性	tenderness
温室	greenhouse
温尼伯	Winnipeg
温布尔顿	Wimbledon
温布顿	Wimbledon
温度表	thermometer
温得和克	Windhoek
温情脉脉	tender-hearted
温文	genteel
温暖	warm
温柔	tender
温温	mild
温煦	warm
温特图尔	Winterthur
温良恭俭	temperate
温良恭俭让	temperate
温跃层	thermocline
温雅	gentle
溶剂	solvent
溶解度	solubility
溶质	solute
溶酶体	lysosome
溶体	solution
滂臭	smelly
灭种罪	genocide
灭绝人性	inhuman
灭虫宁	bephenium
滇藏川	Yunnan
滑板	skateboard
滑沙	sandboarding
滑石	talc
滑翔机	glider
滑膛	smoothbore
滑雪索道	ski-lift
滑雪术	skiing
滑雪运动	skiing
滑音	glissando
滓	sediment
滔	deluge
滔天	overwhelming
滔滔	torrential
滞	stagnant
渗人	horrifying
渗出物	exudate
渗析	dialysis
渗沟	sewer
渗滤	percolation
渗碳	carburization
渗色	bleeding
滴下	drip
滴定	titration
滴定管	burette
滴度	chemistry
滴流	trickle
滴里嘟噜	cumbersome
滚子	roller
满场一致	unanimous
满手	handful
满洲	Manchuria
满洲国	Manchukuo
满身尘埃	dusty
渔人	fisherman
渔夫	fisherman
渔妇	fisherwoman
漂亮	pretty
漂白剂	bleach
漂白水	bleach
漂游	drift
漆器	lacquerware
漆黑	pitch-black
溇	drizzle
漏斗	funnel
演出者	performer
演员	actor
演员阵容	troupe
演习	exercise
演讲家	orator
漘	shore
漜	mud
汉	man
汉英	Chinese-English
汉诺威	Hanover
涟漪	ripple
漪	ripple
漱口水	mouthwash
渐冻症	ALS
渐渐	gradually
浆果	berry
泼掉	spill
洁	clean
洁食	kosher
潘多拉	Pandora
潘朵拉	Pandora
潜力	potential
潜望镜	periscope
潜水器	submersible
潜水夫病	bends
潜水夫症	bends
潜水艇	submarine
潜艇	submarine
潜质	potential
潟湖	lagoon
润滑剂	lubricant
润泽	moist
润肤霜	moisturizer
潦倒	disappointed
潭腿	Tantui
潮人	trendsetter
潮水	tide
潮汐	tide
潮男	metrosexual
潮红	flush
潮解性	deliquescent
潸	tearfully
澃	clear
澄渊	clear
涝	flooded
澡	bath
泽兰	Eupatorium
淀粉	starch
淀粉酶	amylase
澳	cove
澳大利亚	Australia
澳洲小鹦鹉	lorikeet
澳际	Aoji
激光	laser
激光器	laser
激光雷达	lidar
激励机制	incentives
激将法	indirect
激素	hormone
激进主义	radicalism
激进分子	radical
浊度	turbidity
浓缩咖啡	espresso
濈	many
濊貊	Yemaek
湿地	wetland
湿润	moist
湿疹	eczema
湿衣	wetsuit
湿黏	clammy
泞	muddy
濠	trench
滨江	riverside
溅射	sputtering
溅开	splash
滤泡	follicle
滤液	filtrate
滤盆	colander
滤锅	colander
瀁	ripples
泻剂	laxative
泻药	laxative
瀑	waterfall
瀑布	waterfall
瀛	ocean
瀛洲	Yingzhou
瀡	slippery
瀼	dewy
洒水机	sprinkler
洒脱	natural
滩涂	mudflat
滩头	beach
火山	volcano
火山学	volcanology
火影忍者	Naruto
火成碎屑	pyroclastic
火星	spark
火星人	Martian
火烈鸟	flamingo
火焰喷射器	flamethrower
火炉	stove
火墙	firewall
火球	fireball
火眼	pinkeye
火苗	flame
火葬场	crematorium
火药	gunpowder
火蜥蜴	salamander
火轮船	steamboat
火鸡	turkey
火麻	hemp
灰尘	dust
灰度	grayscale
灰烬	ashes
灰猎犬	greyhound
灰白	ash-colored
灶台	stovetop
灶神	Zaoshen
灶神星	Vesta
灼急	worried
灼热	scorching
灾	disaster
灾情	calamity
灾殃	disaster
灾祸	disaster
灾难	disaster
灾难性	catastrophic
炊事	cooking
炎炎	scorching
炎症	inflammation
炒家	speculator
炬	torch
炭焙	charcoal-roasted
炭疽热	anthrax
炮仗	firecracker
炮竹	firecracker
炮舰	gunship
炯炯	shining
炱	soot
炳著	eminent
炴	firelight
炸锅	fryer
炸雷	thunderclap
为了	for
为何	why
为富不仁，为仁不富	idiom
炻	stoneware
炻器	stoneware
烈士	martyr
烈度	intensity
烈性	strong
烈日	Liege
乌克兰	Ukraine
乌干达	Uganda
乌德勒支	Utrecht
乌拉圭	Uruguay
乌日	Wuri
乌普萨拉	Uppsala
乌有	nonexistent
乌木	ebony
乌气	anger
乌尔根奇	Urgench
乌特列支	Utrecht
乌兹别克斯坦	Uzbekistan
乌贼	cuttlefish
乌里雅苏台	Uliastai
乌饭果	blueberry
乌鲁鲁	Uluru
乌龙面	udon
烘焙师	baker
烘焙店	bakery
烘炉	oven
烘箱	oven
烜	brilliant
烤炉	oven
烤箱	oven
烤饼	scone
烤面包机	toaster
烯	alkene
烃	hydrocarbon
烃化作用	alkylation
烷	alkane
烷基	alkyl
烷烃	alkane
烹调术	cookery
烹饪	cooking
焊料	solder
焊锡	solder
焓	enthalpy
焜	brilliant
焟	dry
无上	supreme
无人机	drone
无休无止	ceaseless
无偿	free
无两	unparalleled
无匹	incomparable
无原则	unprincipled
无可	can't
无可争议	undeniable
无名之辈	nobody
无害	harmless
无尾熊	koala
无尾猿	ape
无底	bottomless
无微不至	meticulous
无思无虑	untroubled
无息	interest-free
无所不包	all-encompassing
无所不在	omnipresent
无所不知	omniscient
无所不能	omnipotent
无把握	uncertain
无措	helpless
无政府主义	anarchism
无条件	unconditional
无止尽	endless
无比	incomparable
无毛	hairless
无氧	anaerobic
无法无天	lawless
无烟煤	anthracite
无牵无挂	carefree
无瑕	faultless
无生命	non-living
无产阶级	proletariat
无疑	undoubtedly
无症状	asymptomatic
无痕	traceless
无痛	painless
无知觉	senseless
无神论	atheism
无神论者	atheist
无秩序	disorder
无稽	nonsense
无穷无尽	boundless
无算	countless
无纸化	paperless
无丝分裂	amitosis
无线	wireless
无线网络	Wi-Fi
无线网路	Wi-Fi
无缝	seamless
无缺	whole
无翅	wingless
无脊椎	invertebrate
无脊椎动物	invertebrate
无脑	brainless
无与伦比	incomparable
无色	colorless
无菌	sterile
无菌性	aseptic
无处	nowhere
无论何人	whoever
无论何时	whenever
无趣	dull
无足轻重	insignificant
无轨	trackless
无轨电车	trolleybus
无连接	connectionless
无遗	completely
无边无际	limitless
无关痛痒	irrelevant
无限期	indefinitely
无障碍	barrier-free
无需	needless
无题	untitled
无麸质	gluten-free
焦油	tar
焦糖	caramel
焦点	focus
焰	flame
焰火	fireworks
然后	then
然而	however
煁	brazier
炼狱	purgatory
炼金术	alchemy
炼金术士	alchemist
煌	brilliant
煌熠	bright
煎蛋卷	omelet
烟囱	chimney
烟民	smokers
烟气	smoke
烟火	fireworks
烟灰缸	ashtray
烟突	chimney
烟缸	ashtray
烟草	tobacco
烟霞	haze
烟雾剂	aerosol
煚	fire
煜熠	bright
煤油	kerosene
煤渣	slack
煤灰	soot
煤炭	coal
煤砖	briquette
焕	glowing
照明弹	flare
烦心	annoying
烦心事	troubles
烦闷	moody
煽动性	provocative
熇	dry
熊孩子	brat
熊蜂	bumblebee
熏香	incense
荧光	fluorescence
熔浆	lava
熔矿炉	furnace
熔解	fusion
熙提	stilb
熙攘	restless
熟思	deliberation
熟练工	journeyman
熟练工人	journeyman
熟语	idiom
熟门熟路	familiar
熟食店	deli
熤	person
热切	fervent
热力	heat
热力学	thermodynamics
热射病	heatstroke
热心	enthusiastic
热心肠	warmhearted
热核	thermonuclear
热潮	craze
热词	buzzword
热轧	hot-rolling
热那亚	Genoa
热释光	thermoluminescence
热门	popular
热电	pyroelectric
热电偶	thermocouple
热香饼	pancake
熿	brilliant
燃料	fuel
灯心	lampwick
灯柱	lamppost
灯火	lights
灯笼	lantern
灯台	lampstand
灯蛾	moth
炖饭	risotto
烧水壶	kettle
烧脑	brain-bending
烧鸟	yakitori
燕子	swallow
燕麦	oats
营地	camp
营寨	barracks
营业收入	revenue
营火	campfire
营销	marketing
营养学	nutriology
营养物质	nutrient
营养素	nutrient
燠	warm
燧人	Suiren
燧人氏	Suirenshi
燧发枪	flintlock
燧石	flint
燨	fire
燹	conflagration
熏肉	bacon
熏蒸剂	fumigant
烬	ashes
爆弹	bomb
爆破手	dynamiter
爆竹	firecracker
爆裂物	explosives
炉床	hearth
炉灶	stove
炉边	fireside
爓	flame
烂人	lowlife
烂俗	clichéd
烂崽	low-life
烂摊子	shambles
爝	torch
爬犁	sledge
爬虫动物	reptile
爬行动物	reptile
争夺战	struggle
争战	fight
争论点	contention
争议性	controversial
父	father
父权制	patriarchy
父母	parents
父母亲	parents
父老	elders
爹	dad
爷爷	grandpa
爽意	pleasant
爽畅	pleasant
爽歪了	amazing
爽直	straightforward
尔来	lately
墙壁	wall
墙纸	wallpaper
片语	phrase
片头	intro
片麻岩	gneiss
版式	format
版权	copyright
牌号	trademark
牍	documents
牙侩	broker
牙痛	toothache
牙石	tartar
牙科	dentistry
牙科医生	dentist
牙签	toothpick
牙结石	tartar
牙买加	Jamaica
牙医	dentist
牙龈炎	gingivitis
牛仔	cowboy
牛仔布	denim
牛奶糖	toffee
牛排	steak
牛排馆	steakhouse
牛犊	calf
牛痘	cowpox
牛皮癣	psoriasis
牛磺酸	taurine
牛肉	beef
牛蛙	bullfrog
牛角包	croissant
牛角面包	croissant
牛轭	yoke
牛头	Ox-Head
牛头犬	bulldog
牛饮	gulp
牛魔王	Gyuumao
牛黄	bezoar
牡牛	bull
牡蛎	oyster
牢狱	prison
牢狱之灾	imprisonment
牤牛	bull
牧民	herdsman
牧神节	Lupercalia
牧羊人	shepherd
牧羊犬	sheepdog
牧羊者	shepherd
牧草	fodder
物主	owner
物件	object
物候学	phenology
物品	articles
物料	material
物流管理	logistics
物物交换	barter
物理	physics
物理学	physics
物理学家	physicist
物种	species
物体	object
牲畜	livestock
牳	bovine
牸牛	cow
牸马	mare
特伦顿	Trenton
特内里费	Tenerife
特化	specialization
特古西加尔巴	Tegucigalpa
特定	special
特技演员	stuntman
特技跳伞	skydiving
特拉法尔加	Trafalgar
特拉华	Delaware
特拉华州	Delaware
特易购	Tesco
特此	hereby
特发性	idiopathic
特立尼达	Trinidad
特罗多斯	Troodos
特艺彩色	Technicolor
特制	custom-made
特许状	charter
犀牛	rhinoceros
犀鸟	hornbill
犁	plow
犁沟	furrow
犁铧	plowshare
犄角	horn
犉	ox
犍牛	bullock
犎牛	bison
犊子	calf
牺	sacrifice
犬儒	cynic
犬儒主义	cynicism
犬夜叉	Inuyasha
犬戎	Quanrong
犬舍	kennel
犯浑	confused
犯罪分子	criminal
犯罪学	criminology
犰狳	armadillo
状声词	onomatopoeia
狂乱	hysterical
狂人	madman
狂怒	furious
狂悖	outrageous
狂欢节	carnival
狂犬病	rabies
狄俄倪索斯	Dionysus
狆	Pekingese
狐	fox
狐猴	lemur
狐獴	meerkat
狒狒	baboon
狗仔	paparazzi
狗仔队	paparazzi
狗屁不通	nonsensical
狗屋	kennel
狗东西	scumbag
狗狗	doggie
狗窝	doghouse
狗腿	lackey
狗舍	kennel
狘	jump
狠绝	ruthless
狡猾	crafty
狭小	narrow
狭窄	narrow
狭谷	glen
狭路	gorge
狼人	werewolf
狼狗	wolfdog
猋	whirlwind
猓	monkey
猖	ferocious
猗	interj.
猛丁	suddenly
猛地	suddenly
猛烈	fierce
猛然	suddenly
猝	abruptly
猝然	suddenly
猝睡症	narcolepsy
猞猁	lynx
猢狲	macaque
猩	ape
猩红	scarlet
猴儿	monkey
猴猴族	Qauqaut
猴痘	monkeypox
犹他	Utah
犹他州	Utah
犹地亚	Judea
犹太人	Jew
犹太复国主义	Zionism
犹太教	Judaism
犹太教堂	synagogue
犹太会堂	synagogue
犹如	like
犹达	Jude
猸子	mongoose
猾	sly
猿	ape
猿人	apeman
狱	prison
狮虎兽	liger
狮身人面像	sphinx
狮鹫	griffin
獉	jungle
奖赏	reward
獚	spaniel
獜	firefly
獠牙	tusk
獢	dog
独一无二	unmatched
独个	alone
独到	original
独奏	solo
独家	exclusive
独居石	monazite
独特	unique
独独	alone
独眼巨人	cyclops
独自	alone
独行	solitary
独行侠	loner
独裁	dictatorship
独角兽	unicorn
獬豸	Xiezhi
狞	fierce-looking
狞猫	caracal
获胜者	victor
获得者	recipient
获奖者	prizewinner
获益者	beneficiary
猎	hunting
猎人	hunter
猎户	hunter
猎手	hunter
猎物	prey
猎犬	hound
猎豹	cheetah
猎鹰	falcon
兽奸	bestiality
兽性	brutal
兽疫	epizootic
兽装	fursuit
兽类	animals
猕猴	macaque
獾	badger
玄乎	unreliable
玄孙	great-great-grandson
玄幻	xuanhuan
玄虚	arcane
玄关	vestibule
率	rate
玈	black
玉	jade
玉泉营	Yuquanying
玉米花	popcorn
玉米赤霉烯酮	zearalenone
玉米面	cornmeal
玉素甫	Yusuf
玉兰花	magnolia
玉蜀黍	corn
玉衡	Alioth
王侯	aristocracy
王侯公卿	aristocracy
王八蛋	bastard
王冠	crown
王家	princely
王府井	Wangfujing
王座	throne
王朝	dynasty
玓	pearly
玢	porphyrites
玤	gem
玩伴	playmate
玩咖	playboy
玩物	toy
玩者	player
玫瑰花	rose
玭	pearl
玻利尼西亚	Polynesia
玻利维亚	Bolivia
玻璃化	vitrification
玻璃纸	cellophane
玻璃纤维	fiberglass
珃	jade
珉	alabaster
珊	coral
珊瑚	coral
珍多冰	cendol
珍珠岩	perlite
珍珠翡翠白玉汤	cabbage
珍贵	precious
珔	jade
珖	jade
珙	gem
珞	neck-ornament
珞巴语	Lhoba
珠母	mother-of-pearl
珣	gem
珧	mother-of-pearl
班伯利	Bunbury
班吉	Bangui
班图斯坦	Bantustan
班基	Bangui
班房	jail
班珠尔	Banjul
班竹	Banjul
珽	scepter
现代	Hyundai
现代性	modernity
现代集团	Hyundai
现在	now
现如今	nowadays
现实主义	realism
现时	current
现款	cash
现象学	phenomenology
现象级	phenomenal
现金	cash
现钱	cash
球孢子菌病	Coccidioidomycosis
球形	spherical
球状	sphere
球状物	globe
球蛋白	globulin
球面	sphere
球体	spheroid
理事会	council
理光	Ricoh
理儿	reason
理则学	logic
理学	science
理工男	geek
理性主义	rationalism
理想主义	idealism
理应	should
理当	should
理疗	physiotherapy
理疗师	physiotherapist
理神论	deism
理发员	barber
理发师	barber
理发院	barbershop
琇	jade
琥珀	amber
琨	jade
琭	jade
琲	necklace
琳	gem
琴鸟	lyrebird
琵琶	pipa
琵琶鱼	anglerfish
珐琅	enamel
瑀	chalcedony
瑁	jade
瑏	jade
瑙鲁	Nauru
瑞典	Sweden
瑞典人	Swede
瑞士	Switzerland
琐事	trifle
琐细	trivial
琐罗亚斯德	Zoroaster
琐罗亚斯德教	Zoroastrianism
琐罗亚斯特	Zoroaster
玛律	Malé
玛拉基亚	Malachi
玛瑙贝	cowrie
玛莎拉蒂	Maserati
瑭	jade
璇	jade
璠	gem
璥	gem
璨美	resplendent
环保主义	environmentalism
环保主义者	environmentalist
环烷烃	cycloalkane
环球化	globalization
环礁	atoll
环节动物门	Annelidan
环衬	endpaper
瑸	pearl
琼脂	agar
璎	necklace
瓖	ornaments
瓜德罗普	Guadeloupe
瓜达拉哈拉	Guadalajara
瓜达尔	Gwadar
瓜达尔卡纳尔岛	Guadalcanal
瓠	gourd
瓦加杜古	Ouagadougou
瓦努阿图	Vanuatu
瓦勒他	Valletta
瓦器	pottery
瓦杜兹	Vaduz
瓦尔基里	valkyrie
瓦尔特	Walter
瓦当	eaves-tile
瓦莱塔	Valletta
瓦西里	Vasiliy
瓦都兹	Vaduz
瓦隆	Walloon
瓶塞钻	corkscrew
瓶胚	preform
瓶装	bottled
甘味	sweetness
甘味剂	sweetener
甘味料	sweetener
甘托克	Gantok
甘油三脂	triglyceride
甘油三酯	triglyceride
甘甜	sweet
甘纳豆	amanattō
甘菊	chamomile
甘蔗渣	bagasse
甘蓝菜	cabbage
甘愿	willingly
甚平	jinbei
甚是	extremely
甚至	even
甚巨	considerable
甜	sweet
甜味	sweetness
甜品	dessert
甜瓜	muskmelon
甜甜圈	doughnut
甜菊糖	stevioside
甜菊糖苷	stevioside
甜菊苷	stevioside
甜头	benefit
甜点	dessert
生分	estranged
生动	lively
生化	biochemistry
生化学	biochemistry
生化需氧量	BOD
生命力	vitality
生命多样性	biodiversity
生命线	lifeline
生境	habitat
生存环境	habitat
生态友好型	eco-friendly
生态圈	ecosphere
生态学	ecology
生态学家	ecologist
生态旅游	ecotourism
生态环境游	ecotourism
生态系统	ecosystem
生有权	birthright
生殖力	fertility
生殖腺	gonad
生殖轮	svadhisthana
生煎	shengjian
生物传感器	biosensor
生物力学	biomechanics
生物化学	biochemistry
生物化学家	biochemist
生物反应器	bioreactor
生物圈	biosphere
生物多元化	biodiversity
生物多样性	biodiversity
生物学	biology
生物学家	biologist
生物专一性	biospecificity
生物工程学	biotechnology
生物性	biological
生物恐怖主义	bioterrorism
生物晶片	biochip
生物材料	bio-materials
生物柴油	biodiesel
生物气体	bio-gas
生物活化性	bioactivity
生物测定	bioassay
生物燃料	biofuel
生物科技	biotechnology
生物群	biota
生物能	bio-energy
生物质	biomass
生物质能	biomass
生物量	biomass
生物降解	biodegradation
生物体	organism
生物高分子	biopolymers
生物碱	alkaloid
生理	physiology
生理学	physiology
生理学家	physiologist
生理性	physiological
生产企业	manufacturer
生苔	mossy
生计	livelihood
生辰	birthday
生还者	survivor
生鱼片	sashimi
生面团	dough
产婆	midwife
产后	postnatal
产量	output
甥	nephew
甥女	niece
用场	use
用度	expense
用户名	username
用法	usage
用途	use
用量	usage
甪端	Luduan
田土	farmland
田亩	field
田纳西	Tennessee
田纳西州	Tennessee
田舍	farmhouse
田鼠	vole
由来	origin
甲基安非他命	methamphetamine
甲基苯丙胺	methamphetamine
甲壳动物	crustacean
甲壳素	chitin
甲壳虫	beetle
甲壳类	crustacean
甲胄	armor
甲虫	beetle
甲铠	armor
申请人	applicant
男中音	baritone
男人婆	tomboy
男修道院长	abbot
男友	boyfriend
男女同校	coeducation
男孩子	boy
男巫	wizard
男性主义	masculism
男性厌恶	misandry
男性贬抑	misandry
男朋友	boyfriend
男根	penis
男爵	baron
男的	man
界标	landmark
界限	boundary
畔	edge
畔援	domineering
留兰香	spearmint
留言本	guestbook
留饮	dropsy
畚斗	dustpan
畟	sharp
毕加索	Picasso
毕业生	graduate
毕达哥拉斯	Pythagoras
略图	sketch
略微	slightly
略为	slightly
略略	slightly
略码	code
略称	abbreviation
略语	abbreviation
番木瓜	papaya
番茄	tomato
番茄红素	Lycopene
画作	painting
画刷	paintbrush
画架	easel
画质	resolution
异丁烷	isobutane
异性恋主义	heterosexism
异戊二烯	isoprene
异步	asynchronous
异特龙	allosaurus
异端	heresy
异装癖	transvestism
异见者	dissident
异议	objection
异议人士	dissident
异议分子	dissident
异质	heterogeneous
异质体	variant
异乡人	stranger
当啷	clanging
当地	local
当局	authorities
当责	accountability
当头	surety
畸型	malformation
畸胎	monster
疆土	territory
疆域	territory
疆场	battlefield
叠层岩	stromatolite
叠层石	stromatolite
疋	foot
疏勒国	Shule
疐	prostrate
疑念	doubt
疑惧	misgivings
疝	hernia
疝气	hernia
疢	disease
疣猪	warthog
疤痕	scar
疥	scabies
疫	plague
疫苗	vaccine
疲	weary
疲劳症	fatigue
疳	rickets
疶	dysentery
疸	jaundice
疹子	rash
疽	gangrene
疾病	disease
痂	scab
痂皮	scab
痄	mumps
病厌厌	sickly-looking
病榻	sickbed
病毒	virus
病毒性	viral
病毒血症	viremia
病理	pathology
病理学	pathology
病理学家	pathologist
病者	patient
症状性	symptomatic
症象	symptom
痔疮	hemorrhoid
痘痕	pockmark
痘痘	pimple
痘苗	vaccine
痉	spasm
痛经	dysmenorrhea
痛风	gout
痢	dysentery
痢疾	dysentery
痤	acne
痤疮	acne
痧	cholera
痭	menorrhagia
痯	ill-looking
痰盂	spittoon
痰盂式	spittoon-shaped
痴人说梦	nonsense
痴呆症	dementia
痴心	infatuation
痼癖	addiction
痿	atrophy
瘃	chilblain
瘊	wart
瘊子	wart
疯狂	crazy
瘖	mute
瘟疫	plague
疮疤	scar
疮痂	scab
疮疡	sore
瘢痕	scar
瘤	tumor
瘤子	tumor
瘥	disease
瘦伶仃	emaciated
瘦削	slim
瘦长	slim
瘦骨伶仃	scrawny
瘦骨嶙峋	skinny
疟	malaria
疟疾	malaria
疟疾病	malaria
瘭	whitlow
瘆人	scary
瘰螈	triton
瘸	lame
瘘管	fistula
疗法	therapy
疗养院	sanatorium
痨	tuberculosis
瘅	disease
癌	cancer
癌症	cancer
癔病	hysteria
癔症	hysteria
瘪陷	deflated
痴情	infatuation
癞蛤蟆	toad
痈	carbuncle
瘫	paralyzed
癫痫	epilepsy
登山家	mountaineer
登山扣	carabiner
登机证	HK
登记员	registrar
发作性嗜睡病	narcolepsy
发射机	transmitter
发工资日	payday
发明人	inventor
发明家	inventor
发明者	inventor
发棵	budding
发声法	intonation
发薪日	payday
发行商	publisher
发言人	spokesperson
发送器	transmitter
发电量	capacity
白人	Caucasian
白俄罗斯	Belarus
白化病	albinism
白化症	albinism
白名单	whitelist
白喉	diphtheria
白垩	chalk
白报纸	newsprint
白左	naive
白带	leukorrhea
白厅	Whitehall
白斑病	vitiligo
白斑症	vitiligo
白昼	daytime
白果	ginkgo
白榴石	leucite
白沙瓦	Peshawar
白烂	ridiculous
白癜风	vitiligo
白矾	alum
白罗斯	Belarus
白脱牛奶	buttermilk
白色体	leucoplast
白萝卜	daikon
白蛋白	albumin
白蚀症	vitiligo
白血病	leukemia
白银	silver
白钢	steel
白钨矿	scheelite
白雪	snow
白云母	muscovite
白云石	dolomite
白骨顶	coot
白鱼	whitefish
白面儿	heroin
白麻子	pockmark
百事可乐	Pepsi
百兆	100Base-T
百分之	percent
百分数	percentage
百分比	percentage
百合	lily
百合子	Yuriko
百川	rivers
百度	Baidu
百慕大	Bermuda
百岁老人	centenarian
百科事典	encyclopedia
百脚	centipede
百草枯	paraquat
百万	million
百万富翁	millionaire
百变	ever-changing
百越	Baiyue
百足虫	centipede
百灵鸟	skylark
皂石	soapstone
的	target
的里雅斯特	Trieste
皇后区	Queens
皇后镇	Queenstown
皇子	prince
皎厉	proud
皒皒	white
皓	luminous
皘	white
皤	white
皫	white
皭	pure
皮匠	cobbler
皮层	cortex
皮层性	cortical
皮星	picosatellite
皮条客	pimp
皮钦语	pidgin
皮炎	dermatitis
皮尔	Pierre
皮秒	picosecond
皮肤病	dermatosis
皮肤科	dermatology
皮艇	kayak
皮货	furs
皮质醇	cortisol
皮质类固醇	corticosteroid
皮鞋匠	shoemaker
皮鞭	lash
盆子	basin
盆浴	bathtub
益生菌	probiotics
益处	benefit
盎撒	Anglo-Saxon
盎格鲁	Anglo-
盎格鲁萨克逊	Anglo-Saxon
盎然	abundant
盔	helmet
盛宴	feast
盛怒	enraged
盛行率	prevalence
盗匪	bandit
盗贼	robber
盟友	ally
盟邦	ally
尽头	end
监狱	prison
监督人	superintendent
监督者	supervisor
监视孔	peephole
监护人	guardian
监门	gatekeeper
盘膝	cross-legged
盥洗盆	washbowl
盦	container
卢克索	Luxor
卢布尔雅那	Ljubljana
卢恩字母	rune
卢旺达	Rwanda
卢森堡	Luxembourg
卢比安纳	Ljubljana
卢萨卡	Lusaka
目击者	eyewitness
目珠	eyeball
目眩	dizzy
目瞪口呆	stupefied
目录学	bibliography
目镜	eyepiece
盲	blind
盲字	braille
盲肠炎	appendicitis
直到	until
直勾勾	staring
直升机坪	helipad
直布罗陀	Gibraltar
直径	diameter
直截	straightforward
直捷	straightforward
直方图	histogram
直觉	intuition
直觉性	intuitiveness
直隶	Zhili
相互关系	interrelationship
相仿	similar
相似	similar
相似词	synonym
相向	face-to-face
相对比较	relatively
相思病	lovesickness
相悖	contrary
相投	congenial
相术	physiognomy
相亲相爱	inseparable
相貌	appearance
相关性	correlation
相类	similar
省份	province
省便	convenient
省俭	frugal
省略符号	apostrophe
省称	abbreviation
眉毛钳	tweezers
眉头	brows
看不习惯	unfamiliar
看守者	watchman
看客	audience
看板	billboard
看起来	seemingly
真主	Allah
真亮	clear
真个	truly
真凶	culprit
真善美	truth
真如	Tathata
真实	true
真心	wholeheartedness
真心实意	sincere
真数	logarithm
真核	eukaryotic
真格的	real
真皮层	dermis
真确	authentic
真诚	sincere
真髓	essence
眦	canthus
眨眼睛	wink
眹	pupil
眼光短	short-sighted
眼底镜	ophthalmoscope
眼界	scope
眼皮	eyelid
眼皮子	eyelid
眼皮子浅	short-sighted
眼目	eyes
眼眸	eyes
眼睫毛	eyelashes
眼睑	eyelid
眼科学	ophthalmology
眼科医生	ophthalmologist
眼角	canthus
眼角膜	cornea
眼证	eyewitness
眼镜蛇	cobra
众人	everyone
众创空间	hackerspace
众多	numerous
众筹	crowdfunding
睊	look
𪾢	goggle-eyed
困意	sleepiness
睚	canthus
睛	eye
睡意	sleepiness
睡房	bedroom
睡椅	couch
睡眠者	sleeper
睡眠虫	trypanosome
睡衣裤	pajamas
睡袍	nightgown
睡裙	nightgown
睡鼠	dormouse
睫	eyelashes
睫毛	eyelashes
睫毛膏	mascara
睯	gloomy
睾丸	testicle
睾丸激素	testosterone
睾丸甾酮	testosterone
睾丸素	testosterone
睾丸酮	testosterone
睾甾酮	testosterone
瞍	blind
瞑眩	dizziness
瞠目结舌	flabbergasted
瞪羚	gazelle
瞬时	instantaneous
瞬间转移	teleportation
睑	eyelid
瞿昙	Gautama
蒙蒙黑	dusk
矛柄	shaft
矟	lance
知乎	Zhihu
知名	well-known
知恩不报	ungrateful
知识分子	intellectual
知识论	epistemology
矧	interrog.
矩形	rectangle
短剑	dagger
短句	clause
短吻鳄	alligator
短文	article
短暂	brief
短歌	ballad
短简	brief
短缺	shortage
短袜	sock
矮人	dwarf
矮呆病	cretinism
矮黑人	Negrito
矫情	unreasonable
矫饰	affectation
石刁柏	asparagus
石匠	stonemason
石南属	heather
石南树	heath
石墨烯	graphene
石子儿	cobble
石景山区	Shijingshan
石棉	asbestos
石棺	sarcophagus
石榴	pomegranate
石河子	Shihezi
石油化学	petrochemistry
石洞	cave
石渣	gravel
石灰岩	limestone
石灰石	limestone
石片	slab
石状	stony
石磨	grindstone
石笋	stalagmite
石绵	asbestos
石脑油	naphtha
石英	quartz
石质	stony
石钟乳	stalactite
矻矻	assiduously
矽肺病	silicosis
矽藻	diatom
矽铝层	Sial
砂子	sand
砂岩	sandstone
砂砾	grit
砌砖工	bricklaying
砌路	paving
砌体	brickwork
砍刀	machete
砒	arsenic
研究员	researcher
研华	Advantech
研讨	discussion
砟	fragments
砧	anvil
砰	thump
炮艇	gunboat
砳	rocky
破坏性	destructive
破坏活动	sabotage
破布	rag
破缺	breaking
破旧	shabby
破裂音	stop
砷凡纳明	arsphenamine
砷化氢	arsine
砷制剂	arsphenamine
硅藻门	Bacillariophyta
硅酮	silicone
硅酸盐	silicate
硎	whetstone
硐	grind
硁	obstinate
硝化甘油	nitroglycerine
硝酸甘油	nitroglycerine
硝酸盐	nitrate
硫氰酸酶	rhodanase
硫氰酸盐	thiocyanate
硫胺素	thiamine
硫酸盐	sulfate
硫黄	sulfur
硬件	hardware
硬度	hardness
硬拉	deadlift
硬木	hardwood
硬壳	crust
硬壳果	nut
硬玉	jadeite
硬纸	cardboard
硬编码	hard-coded
硬领	collar
砚	ink-stone
硻	obstinate
硼砂	borax
碃	stone
碇	anchor
碎催	lackey
碎块	fragment
碎布条	shred
碎片	chip
碎石	gravel
碎肉	mincemeat
碏	gems
碗柜	cupboard
碞	cliff
碧玉	jasper
碧玺	tourmaline
硕大无朋	huge
硕大无比	huge
碬	whetstone
碳化物	carbide
碳氢化合物	hydrocarbon
碳水化合物	carbohydrate
砜	sulfone
确定性	determinacy
确是	certainly
码率	bitrate
码头	wharf
碾槌	pestle
碾盘	millstone
碾砣	roller
磁气圈	magnetosphere
磁石	magnet
磁轨炮	railgun
磁铁	magnet
磐石	boulder
砖块	brick
砖石	brick
砖头	brick
磨坊	mill
磨坊主	miller
磨子	mill
磨砂机	sander
磷光	phosphorescence
磷火	phosphorescence
磷石	muscovite
磷矿石	phosphate
磷脂	phospholipid
磷虾	krill
磷酸盐	phosphate
磺	sulfur
礁湖	lagoon
礁石	reef
硚头	Qiaotou
礜	arsenic
礞	mineral
矿山	mine
矿工	miner
矿物	mineral
矿物学	mineralogy
矿物质	mineral
矿产	minerals
矿石	ore
矿盐	halite
矾	alum
礵	arsenic
示威运动	rally
示性	expressivity
礽	blessings
社会主义	socialism
社会主义者	socialist
社会名流	celebrity
社会学	sociology
社会性	social
社会环境	milieu
社会等级	class
社会经济	socio-economic
社会语言学	sociolinguistics
祆教	Zoroastrianism
祉	felicity
秘结	constipation
祖国	motherland
祖母绿	emerald
祖鲁	Zulu
祝融	Zhurong
神	God
神不守舍	dazed
神奈川	Kanagawa
神学家	theologian
神学研究所	seminary
神学院	seminary
神庙	temple
神性	divinity
神情	look
神憎鬼厌	loathsome
神户	Kobe
神格	Godhead
神枪手	sharpshooter
神权政治	theocracy
神权统治	theocracy
神殿	shrine
神汉	sorcerer
神社	shrine
神祖	Godhead
神祠	shrine
神秘主义	mysticism
神经元	neuron
神经外科	neurosurgery
神经学	neurology
神经学家	neurologist
神经官能症	neurosis
神经毒素	neurotoxin
神经生物学	neurobiology
神经症	neurosis
神经细胞	neuron
神经衰弱	neurasthenia
神话故事	myth
神谕	oracle
神迹	miracle
神农架	Shennongjialin
神农架地区	Shennongjialin
神农架林区	Shennongjialin
神造论	creationism
神道教	Shinto
神体	Godhead
神龛	shrine
票价	fare
祭司	priest
祭司权术	priestcraft
祭品	offering
祭坛	altar
祭物	sacrifices
禄蠹	sinecurist
禁夜	curfew
禁欲主义	asceticism
禋	sacrifice
福佬	Hoklo
福摩萨	Formosa
福音书	gospel
禔	well-being
禜	sacrifice
禧	joy
礼拜一	Monday
礼拜三	Wednesday
礼拜二	Tuesday
礼拜五	Friday
礼拜仪式	liturgical
礼拜六	Saturday
礼拜四	Thursday
礼拜天	Sunday
礼拜日	Sunday
礼节	etiquette
礼花	fireworks
礼宾员	concierge
禸	trample
禽龙	iguanodon
禾秆	straw
禾草	grass
秀色孙鲽	yellowtail
秀丽	pretty
私办	privately-run
秋海棠	begonia
秋叶原	Akihabara
科伦坡	Colombo
科克	Cork
科威特	Kuwait
科学主义	scientism
科摩洛	Comoros
科浦	Coop
科尔多瓦	Córdoba
科系	department
科纳克里	Conakry
科索沃	Kosovo
科罗拉多	Colorado
科罗拉多州	Colorado
科迪勒拉	Cordillera
科迪勒拉山系	Cordillera
科隆水	cologne
秒表	stopwatch
秘书	secretary
秘书长	secretary-general
秘鲁	Peru
租客	tenant
租约	lease
租金	rent
秠	millet
秧歌	Yangge
秧苗	seedling
秩序	order
秭	billion
秸秆	straw
移动式	mobile
移动性	mobility
移植性	portability
移液器	pipette
稀世	rare
稀奇古怪	bizarre
稀有	uncommon
稀饭	porridge
稀松平常	ordinary
税捐	tax
税收	taxation
税费	tax
程序员	programmer
程序性	program
程度	degree
稍快板	allegretto
稛	full
棱柱	prism
棱台	prism
稞	wheat
禀赋	gift
稠密	dense
种子岛	Tanegashima
种族	race
种族中心主义	ethnocentrism
种族主义	racism
种族灭绝	genocide
种植园	plantation
种植业	plantation
种脐	omphalodium
种苗	seedling
称心如意	gratifying
称谓	title
稻草人	scarecrow
稽查	inspection
稽查人员	inspector
稿件	manuscript
谷仓	barn
谷壳	chaff
谷神星	Ceres
谷草	straw
谷饲	grain-fed
穄	millet
穆斯林	Muslim
穆萨维	Moussavi
穆迪	Moody's
穆黑	Islamophobe
穊	dense
积极进取	proactive
积渐	gradually
积累性	cumulative
积金累玉	prosperous
积雪场	snowpack
穗饰	tassel
秽	filthy
秽水	sewage
稳	settled
稳妥	dependable
稳定币	stablecoin
稳定性	stability
穸	tomb
穹丘	dome
空前	unprecedented
空心面	macaroni
空性	emptiness
空想性错视	pareidolia
空手道	karate
空气动力学	aerodynamics
空气流通	ventilation
空空荡荡	deserted
空缺	vacancy
空腔	cavity
空着手	empty-handed
空荡荡	empty
空降兵	paratroopers
穿堂风	draft
穿洞	pierce
穿着	attire
突厥斯坦	Turkestan
突尼斯市	Tunis
突击队员	commando
突然	sudden
突然间	suddenly
突破性	groundbreaking
突触	synapse
突触后	postsynaptic
窌	cellar
窗子	window
窗帷	curtain
窗幔	curtain
窗台	windowsill
窘况	predicament
窠	nest
窨	cellar
窨井	manhole
窝咑	otak
窝巢	nest
窝料	groundbait
窝点	lair
洼地	depression
穷极	extremely
窃贼	thief
立刻	immediately
立即	immediately
立时	quickly
立法机关	legislature
立绒	velvet
立卧撑跳	burpee
立足点	foothold
立陶宛	Lithuania
立体派	Cubism
立鱼	tilapia
站姿	stance
站街女	streetwalker
章则	rule
章鱼	octopus
童	child
童儿	boy
童子	boy
童年	childhood
竭诚	wholeheartedly
端到端	end-to-end
端粒	telomere
端粒酶	telomerase
竞技场	arena
竞技性	competitive
竞争对手	rival
竞争性	competitive
竞争者	competitor
竞赛者	player
竹篱笆	fence
竹编	wickerwork
竿	pole
笑吟吟	smiling
笑声	laughter
笙	sheng
笛	flute
笤	broom
符文	rune
符号	symbol
符记	token
笨货	idiot
笨头笨脑	muddle-headed
第一手	first-hand
第一流	first-class
第三十	thirtieth
第五	fifth
笰	duster
笔刷	paintbrush
笔迹	handwriting
等周	isoperimetric
等效	equivalent
等温	isothermic
等级制度	hierarchy
等距	equidistant
筋脉	veins
筏子	raft
策展人	curator
筰	cable
筵上	feast
筷	chopstick
筷子芥	Arabis
箂	bamboo
箍桶店	coopery
箑	fan
算命先生	fortune-teller
算命家	fortune-teller
算命者	fortune-teller
算术	arithmetic
箙	quiver
管取	sure
管弦乐团	orchestra
管弦乐队	orchestra
管理人	supervisor
箭毒木	antiaris
箭镞	arrowhead
箱根	Hakone
节候	season
节俭	frugal
节奏口技	beatboxing
节庆	festival
节拍器	metronome
节气门	throttle
节略	abbreviation
节疤	gnarl
节肢介体病毒	arbovirus
节肢动物	arthropod
节点	node
范例	example
范儿	manner
范式	paradigm
范畴	category
篇什	poem
篇章	chapter
筑城	fortification
篜	bamboo
篝火	bonfire
篡贼	usurper
筚	wicker
篴	flute
篷	sail
篷布	tarpaulin
簉室	concubine
篓	basket
篓子	basket
簜	bamboo
简单	simple
简直	simply
简笔画	sketch
简编	compendium
簧风琴	harmonium
簪	hairpin
箫	xiao
簬	bamboo
檐篷	awning
签字者	signatory
签章	signature
帘子	curtain
簿记	bookkeeping
篮板	backboard
篮筐	basket
篮网球	netball
筹子	chip
筹款	fundraising
筹略	astute
籍籍无名	unknown
笼子	cage
笼子	trunk
笼鸟槛猿	prisoner
箩	basket
米白色	off-white
米粒组织	granulation
米粥	congee
米糠	bran
米纳尔迪	Minardi
米该亚	Micah
米黄	beige
籵	dm
籽	seeds
粁	kilometer
粉土	silt
粉拳	soft
粉砂	silt
粉砂岩	siltstone
粉砂石	siltstone
粉红	pink
粉红色	pink
粒细胞	granulocyte
粗俗	vulgar
粗劣	coarse
粗暴	crude
粗砂	grit
粗管面	rigatoni
粗莽	brusque
粘扣	velcro
粘皮带骨	indecisive
粘稠	viscous
粘糯	sticky
粱	sorghum
粤海	Guangdong-Hainan
精力	energy
精品店	boutique
精囊	spermatophore
精子	spermatozoon
精工	Seiko
精巧	elaborate
精度	precision
精明	astute
精液	semen
精确	accurate
精神分析	psychoanalysis
精神分裂症	schizophrenia
精神学	psychology
精神学家	psychologist
精神官能症	neurosis
精神病学	psychiatry
精神科	psychiatry
精神科医生	psychiatrist
精神错乱	insanity
精算	actuarial
精算师	actuary
精致	delicate
精美	exquisite
精制	refined
精髓	marrow
糅	mix
糊墙纸	wallpaper
糊精	dextrin
糌粑	tsampa
糍粑	ciba
糕	cake
糖原	glycogen
糖尿病	diabetes
糖汁	syrup
糖浆	syrup
糖精	saccharin
糖脂	glycolipid
糖苷	glucoside
糖萼	glycocalyx
糖蛋白	glycoprotein
糜	millet
糜烂性毒剂	vesicant
粪化石	coprolite
粪石	coprolite
粪蛆	muckworm
糢	blurred
团	dumpling
系统性	systematic
纠纷	dispute
纪律	discipline
纪念品	souvenir
纪念奖	trophy
纪念碑	monument
约克	York
约定资讯速率	CIR
约沙法	Jehoshaphat
约章	charter
约纳	Jonah
约翰内斯堡	Johannesburg
约翰斯顿	Johnston
红利	bonus
红加仑	redcurrant
红名单	whitelist
红娘	matchmaker
红学	"Redology"
红客	"honker"
红宝石	ruby
红日	sun
红橙黄绿蓝靛紫	red
红火	prosperous
红玛瑙	cornelian
红璧玺	topaz
红脖子	redneck
红肠	saveloy
红霉素	erythromycin
红头菜	beetroot
红霉素	erythromycin
纥	knot
纥	tassels
纳什维尔	Nashville
纳匝肋	Nazareth
纳塔乃耳	Nathaniel
纳尼亚	Narnia
纳星	nanosatellite
纳瓦萨	Navassa
纳瓦霍	Navajo
纳税人	taxpayer
纳米	nanometer
纳米技术	nanotechnology
纳米比亚	Namibia
纳粹主义	Nazism
纳粹分子	Nazi
纳卫星	nanosatellite
纳豆	nattō
纳骨塔	columbarium
纳鸿	Nahum
纽伦堡	Nuremberg
纽卡素	Newcastle
纽子	button
纽扣	button
纯品	sterling
纯度	purity
纯真天然	natural
纯种	purebred
纯血	pure-blooded
纯血统	pure-blood
纯碱	Na2CO3
纱布	gauze
纱绽	spindle
纱线	yarn
纸张	paper
纸板	cardboard
纸烟	cigarette
纸盒	carton
纸草	papyrus
纸钞	banknote
纸鸢	kite
纸鹞	kite
素来	consistently
素描	sketch
素日	usually
素食主义	vegetarianism
素食者	vegetarian
纺织者	weaver
纺锤	spindle
索具装置	rig
索多玛	Sodom
索尼	Sony
索引	index
索索	trembling
索道	ropeway
索里亚	Soria
索非亚	Sofia
索马里	Somalia
紫丁香	lilac
紫斑	bruise
紫水晶	amethyst
紫石英	amethyst
紫菜包饭	gimbap
紫藤	wisteria
䌷	silk
细化管理	micromanagement
细姨	concubine
细嫩	tender
细小病毒	parvovirus
细小病毒科	Parvoviridae
细心	meticulous
细挑	slender
细支气管炎	bronchiolitis
细碎	fragments
细节	details
细粉	powder
细胞器	organelle
细胞因子	cytokine
细胞学	cytology
细胞毒	cytotoxin
细胞毒性	cytotoxicity
细胞色素	cytochrome
细胞质	cytoplasm
细长	slender
细颈瓶	jug
细香葱	chive
绅士	gentleman
𫄟	rough
终端机	terminal
组合论	combinatorics
组块	chunk
组织学	histology
组织者	organizer
组织胞浆菌病	histoplasmosis
组织胺	histamine
结存	balance
结晶学	crystallography
结晶状	crystalline
结核病	tuberculosis
结构主义	structuralism
结壳	crust
结球甘蓝	cabbage
结石	stone
结结巴巴	stammeringly
结肠镜检查	colonoscopy
结膜炎	conjunctivitis
结点	joint
绝壁	precipice
绝妙	exquisite
绝对	absolute
绝经	menopause
绝色	stunning
绝顶聪明	brilliant
绦虫	tapeworm
絜	clean
绞刀	reamer
绞盘	capstan
络绎	continuous
绚丽多彩	gorgeous
绒布	flannel
绒球	pompon
统一性	unity
统一码	Unicode
统治力	dominance
统治者	ruler
统统	totally
统计员	statistician
统计学	statistics
统通	everything
丝囊	spinneret
丝带	ribbon
丝柏	cypress
丝状	thread-like
丝状物	filament
丝状病毒	filovirus
丝瓜	luffa
丝米	decimillimeter
丝绒	velvet
绛	purple-red
绢	thin
绑匪	kidnapper
绥靖主义	appeasement
经世	statecraft
经度	longitude
经撞	shock-resistant
经济学家	economist
经济学者	economist
经济有效	cost-effective
经由	via
经痛	dysmenorrhea
经纬仪	theodolite
经闭	amenorrhoea
经验主义	empiricism
综合征	syndrome
综合性	synthesis
综合症	syndrome
综效	synergy
综析	synthesis
绿宝石	beryl
绿油油	verdant
绿洲	oasis
绿色	green
绿花椰菜	broccoli
绿花菜	broccoli
绿菜花	broccoli
维也纳	Vienna
维京人	Viking
维吉尼亚	Virginia
维吉尼亚州	Virginia
维和	peacekeeping
维基数据	Wikistats
维基物种	Wikispecies
维基解密	WikiLeaks
维多利亚州	Victoria
维冈	Wigan
维尔纽斯	Vilnius
维生素	vitamin
维管	vascular
维维安	Vivien
维纶	vinylon
维罗纳	Verona
网上	online
网孔	mesh
网易	NetEase
网景	Netscape
网架	rack
网民	netizen
网目	mesh
网眼	mesh
网站	website
网络	Internet
网络俚语	netspeak
网络欺诈	phishing
网络水军	astroturfers
网络空间	cyberspace
网络语言	netspeak
网语	netspeak
网际网络	Internet
网飞	Netflix
绰名	nickname
绰约	charming
绰号	nickname
绵羊	sheep
绵远	remote
紧张缓和	detente
紧急事件	emergency
紧身	skintight
緎	seam
线上	online
线报	tip-off
线状	linear
线粒体	mitochondrion
线绳	cord
线虫	nematode
缎	satin
缎子	satin
缎布	satin
缎带	ribbon
缘饰	fringe
编务	editing
编码器	encoder
编者	editor
编译器	compiler
编辑室	newsroom
缓兵之计	stalling
缓动	sluggish
缓慢	slow
缅元	kyat
缅因	Maine
缅因州	Maine
纬度	latitude
𦈕	net
缏	braid
致	delicate
致密	fine
縡	matter
县	county
县域	county
缝衣匠	tailor
缝衣工人	needleworker
缝针迹	seam
缩小模型	miniature
缩微平片	microfiche
缩手缩脚	constrained
缩称	abbreviation
𬙂	long
纵横字谜	crossword
纵火犯	arsonist
总共	altogether
总和	sum
总干事	secretary-general
总是	always
总归	anyhow
总社	headquarters
总站	terminus
总要	nevertheless
总论	overview
繁荣	prosperous
繁荣昌盛	thriving
繁茂	luxuriant
繁复	complicated
繁杂	many
繁闹	bustling
绷床	trampoline
绷簧	spring
织品	textile
织布机	loom
织机	loom
织物	fabric
绕口令	tongue-twister
绣	embroidery
绣帷	tapestry
绣球花	hydrangea
绳索	rope
绳结	knot
绘文字	emoji
系囚	prisoner
䍁	tassel
继任者	successor
继兄弟姐妹	step-siblings
继子	stepson
继承者	successor
继母	stepmother
继父	stepfather
继父母	step-parents
𫄸	crimson
续作	sequel
缠足	foot-binding
纤毛	cilium
纤维状	fibrous
纤维素	cellulose
纤维肌痛	fibromyalgia
纤维胶	viscose
缆索吊椅	ski-lift
缆线	cable
缶	pottery
缺嘴	harelip
缺德	mean
缺氧症	anoxia
缺陷	defect
缺额	vacancy
罂粟	poppy
罕	rare
罩子	cover
罩衫	smock
罪人	sinner
罪犯	criminal
罪疚	guilt
罪责	guilt
罭	drag-net
置景	cinema
罚则	penalty
罳	screen
罗伯茨	Roberts
罗杰	Roger
罗杰斯	Rogers
罗切斯特	Rochester
罗利	Raleigh
罗姆人	Romani
罗安达	Luanda
罗宋汤	borscht
罗得斯岛	Rhodes
罗彻斯特	Rochester
罗托鲁瓦	Rotorua
罗斯托夫	Rostov-on-Don
罗氏	Roche
罗汉肚	potbelly
罗洁爱尔之	Raziel
罗盘	compass
罗纳	Rhone
罗纳河	Rhone
罗索	Roseau
罗缎	ribbed
罗兹	Łódź
罗非鱼	tilapia
罗马	Rome
罗马化	romanization
罗马尼亚	Romania
羊怪	faun
羊毛衫	cardigan
羊痫风	epilepsy
羊癫疯	epilepsy
羊皮	sheepskin
羊皮纸	parchment
羊羔	lamb
羊羹	yōkan
羊膜穿刺	amniocentesis
羊膜穿刺术	amniocentesis
羊角包	croissant
羊角风	epilepsy
羊角面包	croissant
羊驼	alpaca
美中	US-China
美中台	US-China-Taiwan
美人	belle
美人鱼	mermaid
美他沙酮	metaxalone
美利坚	America
美国	USA
美国国家航空航天局	NASA
美国资讯交换标准码	ASCII
美国电话电报公司	AT&T
美团点评	Meituan-Dianping
美学	aesthetics
美式	American-style
美德	virtue
美意	goodwill
美拉尼西亚	Melanesia
美日	US-Japan
美沙酮	methadone
美洲虎	jaguar
美滋滋	elated
美甲师	manicurist
美索不达米亚	Mesopotamia
美食家	gourmet
美馔	delicacy
美丽	beautiful
羔	lamb
羚	antelope
羞愧	ashamed
羞涩	shy
羞答答	bashful
群花	blossom
羧甲司坦	carbocysteine
义大利面	pasta
义卖会	bazaar
羱羊	ibex
𫅗	spirit
羹汤	soup
羽族	birds
羽流	plume
羽茎	quill
羽衣甘蓝	kale
翀	soar
翅展	wingspan
习惯性	customary
习惯用法	idiom
习气	custom
翛	hastiness
翠鸟	kingfisher
翡冷翠	Florence
翮	quill
翳眼	cataract
翼展	wingspan
翼手龙	pterodactyl
翼翼	careful
翼膜	patagium
翼装	wingsuit
翼龙	pterosaur
老幺	youngest
老例	custom
老千	swindler
老土	old-fashioned
老妈	mother
老妈子	amah
老字号	shop
老态龙钟	senile
老抠	penny-pincher
老挝	Laos
老是	always
老梗	hackneyed
老派	old-fashioned
老爸	father
老糊涂	dotard
老练	seasoned
老花	presbyopia
老花眼	presbyopia
老着脸	shamelessly
老视	presbyopia
老视眼	presbyopia
老调重弹	unoriginal
老资格	veteran
老趼	callus
老迈	aged
老酒	wine
老铁	bro
老饕	glutton
老鸟	veteran
老鸹	raven
老雕	vulture
老鹰	hawk
老鼻子	many
考古学	archaeology
考古学家	archaeologist
考古家	archaeologist
考文垂	Coventry
而是	rather
耏	beard
耐克	Nike
耐力	endurance
耐性	patience
耐水	waterproof
耐水性	waterproof
耐洗	wash-resistant
耐用	durable
耐酸	acid-resistant
耐高温	heat-resistant
耐碱	alkali-resistant
耒	plow
耒耜	plow
耕作	farming
耕犁	plow
耗子	rat
耡	hoe
耤	plow
耰	harrow
耳垂	earlobe
耳垢	earwax
耳廓	auricle
耳掴子	slap
耳朵软	credulous
耳根子	ear
耳根子软	credulous
耳根软	credulous
耳源性	otogenic
耳畔	ears
耳痛	earache
耳石	otolith
耳石症	BPPV
耳罩	earmuffs
耳聋	deaf
耳蜗	cochlea
耳软	credulous
耳鸣	tinnitus
耵聍	earwax
耶稣	Jesus
耶稣教	Protestantism
耶路撒冷	Jerusalem
耶鲁	Yale
耿直	honest
耿耿于怀	brooding
聊且	tentatively
聊备一格	token
聎	tinnitus
圣君	sage
圣哲	sage
圣徒	saint
圣歌	hymn
圣殿	temple
圣母	goddess
圣神降临周	Whitsuntide
圣约	covenant
圣职	priesthood
圣药	panacea
圣诗	hymn
圣灵降临	Pentecost
圣餐	Eucharist
聚丙烯	polypropylene
聚光灯	spotlight
聚合作用	polymerization
聚合物	polymer
聚氨酯	polyurethane
聚碳酸酯	polycarbonate
聚苯乙烯	polystyrene
聚酯	polyester
聚酰亚胺	polyimide
闻名于世	world-famous
联合国教科文组织	UNESCO
联合会	federation
联合组织	syndicate
联想	Lenovo
联欢会	party
联氨	hydrazine
联结主义	connectionism
联轴器	coupling
联邦快递	FedEx
联体别墅	townhouse
聪慧	bright
聪敏	bright
聪明伶俐	clever
聪明绝顶	brilliant
聪颖	smart
声价	reputation
声学	acoustics
声明书	statement
声望	reputation
声浪	clamor
声门	glottis
声韵学	phonetics
声类	Shenglei
职位	position
职分	duty
职工	employee
职志	aspiration
职业化	professionalization
职业素质	professionalism
职涯	career
听得见	audible
听诊器	stethoscope
听说读写	listening
聋	deaf
肇事逃逸	hit-and-run
肉丸	meatball
肉乎乎	plump
肉冻	aspic
肉嘟嘟	chubby
肉条	cutlet
肉毒中毒	botulism
肉票	hostage
肉贩	butcher
肉类	meat
肉食	carnivorous
肉食动物	carnivore
肋骨	rib
肌	muscle
肌动蛋白	actin
肌肉男	muscleman
肌肉发达	muscular
肌胃	gizzard
肌酸	creatine
肖恩	Sean
肚	tripe
肚	belly
肚痛	stomachache
肚皮	belly
肚腩	belly
肚脐	navel
肚脐眼	navel
肛	rectum
肛门	anus
肝炎	hepatitis
肝硬化	cirrhosis
肝糖	glycogen
肝脏	liver
股利	dividend
股息	dividend
股骨	femur
肢	limb
肥沃	fertile
肥胖	fat
肥胖症	obesity
肥头大耳	fat
肩并肩	abreast
肩膀	shoulder
肩膊	shoulder
肫	gizzard
肯塔基	Kentucky
肯塔基州	Kentucky
肯尼亚	Kenya
肱骨	humerus
育幼院	orphanage
肵	table
肺气肿	emphysema
肺痨	tuberculosis
肺结核病	tuberculosis
肺脏	lungs
肼	hydrazine
胂	arsine
胂凡纳明	arsphenamine
胃下垂	gastroptosis
胃炎	gastritis
胃疼	stomachache
胃蛋白酶	pepsin
胃袋	belly
胄裔	descendants
胊	yoke
背包客	backpacker
背包游	backpacking
背叛者	traitor
背地里	secretly
背德	immoral
背骨	spine
胍	guanidine
胎便	meconium
胎盘	placenta
胎粪	meconium
胎记	birthmark
胖乎乎	chubby
胗	gizzard
胚	embryo
胚珠	ovule
胚胎	embryo
胚胎学	embryology
胚胎发生	embryogenesis
胚芽鞘	coleoptile
胞宫	uterus
胞浆	cytoplasm
胞藻	algae
胞衣	afterbirth
胡图族	Hutu
胡天	Zoroastrianism
胡桃	walnut
胡椒	pepper
胡椒薄荷	peppermint
胡狼	jackal
胡瓜	cucumber
胡芫	coriander
胡荽	coriander
胡芦巴	fenugreek
胡萝卜	carrot
胡萝卜素	carotene
胭	rouge
胭脂	rouge
胯间	crotch
胰	pancreas
胰岛素	insulin
胰腺	pancreas
胰腺炎	pancreatitis
胰脏	pancreas
胰脏炎	pancreatitis
胳	armpit
胳膊肘	elbow
胳臂箍儿	armband
胳臂肘儿	elbow
胸卡	badge
胸口	chest
胸廓	thorax
胸牌	badge
胸甲	breastplate
胸脯	chest
胸腺	thymus
胸膛	chest
胸膜炎	pleurisy
胸针	brooch
胼胝	callus
能手	expert
能源	energy
能见度	visibility
脂粉	cosmetics
脂肪团	cellulite
脂蛋白	lipoprotein
脆片	chip
脆脆	crispy
脆骨	gristle
脉息	pulse
脉轮	chakra
脊柱侧凸	scoliosis
脊柱侧弯	scoliosis
脊梁骨	backbone
脊椎侧弯	scoliosis
脊椎动物	vertebrate
脊椎动物门	Vertebrata
脊椎指压治疗师	chiropractor
脊椎骨	vertebra
脊索动物	chordata
脊索动物门	Chordata
脊肋	ribcage
脊骨	backbone
脊骨神经医学	chiropractic
脊髓灰质炎	poliomyelitis
脊髓炎	myelitis
脖	neck
脖颈	nape
胫骨	tibia
脱力	exhausted
脱垂	prolapse
脱序	disorder
脱机	offline
脱氧	deoxidation
脱氧核糖	deoxyribose
脱氧核糖核酸	DNA
脱氧麻黄碱	methamphetamine
脱氢	dehydrogenation
脱空汉	liar
脱衣服	undress
脱衣舞	striptease
脬	bladder
胀大	swollen
胀起	bulge
脾	spleen
脾性	temperament
脾脏	spleen
腈	acrylic
腋窝	armpit
腌货	pickles
肾	kidney
肾上腺素	adrenaline
肾脏	kidney
腐肉	carrion
腓力	Philip
腓尼基	Phoenicia
腔棘鱼	coelacanth
腕子	wrist
腕足动物	brachiopod
腕表	wristwatch
腕龙	brachiosaurus
脶	fingerprint
脑内啡	endorphin
脑岛	insula
脑汁	brains
脑浆	brains
脑炎	encephalitis
脑膜炎	meningitis
脑门	forehead
肿瘤	tumor
肿瘤切除术	lumpectomy
腮	cheek
腮帮子	cheek
腮腺炎	mumps
腮胡	sideburns
腰子	kidney
腰肉	loin
腰肢	waist
腰间	waist
腱子	sinew
腱炎	tendonitis
脚凳	footstool
脚印	footprint
脚后跟	heel
脚手架	scaffolding
脚指甲	toenail
脚架	tripod
脚气病	beriberi
脚注	footnote
脚腕	ankle
脚趾	toe
脚趾头	toe
脚跟	heel
脚踏	pedal
脚踝	ankle
脚蹬	pedal
肠	intestines
肠仔	sausage
肠子	intestines
肠支	cecum
肠毒素	enterotoxins
肠炎	enteritis
肠病毒	enterovirus
肠胃炎	gastroenteritis
腹水	hydroperitoneum
腹语	ventriloquism
腹语师	ventriloquist
腹语术	ventriloquism
腺	gland
腺病毒	adenovirus
腺癌	adenocarcinoma
腺苷	adenosine
腺体	gland
腿腕	ankle
腿部	leg
膀胱炎	cystitis
膔	borborygmus
膗	obese
肤	skin
肤浅	superficial
膝	knee
膝盖骨	kneecap
胶乳	latex
胶原蛋白	collagen
胶合板	plywood
胶木	bakelite
胶水	glue
胶泥	clay
胶体	colloid
胶黏	sticky
胶黏剂	glue
膣	vagina
膦	phosphine
膨	swollen
膳	meals
膳食	meals
膵	pancreas
胆囊	gallbladder
胆固醇	cholesterol
胆小如鼠	gutless
胆小鬼	coward
胆石	gallstone
胆石症	gallstone
胆红素	bilirubin
胆结石	gallstone
胆绿素	biliverdin
胆色素	bilirubin
胆颤心惊	panic-stricken
胆魄	boldness
脓	pus
脓毒症	sepsis
脓水	pus
脓液	pus
脓肿	abscess
臀	buttocks
臂	arm
臂纱	armband
臂膀	arm
臂膊	arm
臆想狂	mythomaniac
臆想症	mythomania
脸基尼	facekini
脸孔	face
脸巴子	cheek
脸书	Facebook
脸皮厚	brazen
脸盲	face-blind
脸罩	visor
脸谱	Facebook
脸部	face
脸面	face
脸颊	cheek
脸庞	face
臊腥	stench
腊肠	sausage
脏躁	hysteria
臣仆	servant
臣虏	slave
卧位	berth
卧内	bedroom
卧具	bedding
卧病	bed-ridden
卧龙岗	Wollongong
临床	clinical
临时保姆	babysitter
自上而下	top-down
自下而上	bottom-up
自主权	autonomy
自信心	self-confidence
自传	autobiography
自制力	self-control
自助	self-service
自动化技术	automation
自动射线摄影	autoradiography
自动扶梯	escalator
自动楼梯	escalator
自动车	automobile
自在	comfortable
自大	arrogant
自底向上	bottom-up
自恋	narcissism
自我催眠	self-hypnotism
自我意识	self-awareness
自我批评	self-criticism
自我防卫	self-defense
自拍照	selfie
自指	self-reference
自治	autonomy
自淫	masturbation
自然拼读	phonics
自然段	paragraph
自然神论	deism
自营商	dealer
自由主义	liberalism
自由城	Freetown
自由市	Libreville
自由意志主义	libertarianism
自由放任	laissez-faire
自由派	liberal
自由潜水	freediving
自由素食主义	Freeganism
自由落体	free-fall
自画像	self-portrait
自发	spontaneous
自白书	confession
自给	self-reliant
自举	bootstrapping
自身难保	helpless
自适应	adaptive
自闭症	autism
自顶向下	top-down
自愿	voluntary
自愿性	voluntary
自愿者	volunteer
自高自大	arrogant
臭屁虫	stinkbug
臭气	stench
臭烘烘	stinking
臭熏熏	stinking
臭美	vain
臭臭	poo
臭鼬	skunk
至人	sage
至极	extremely
至诚	sincere
致冷剂	refrigerant
致幻剂	hallucinogen
致死性	lethal
致畸	teratogenic
致癌	carcinogenic
致癌物	carcinogen
台中	Taichung
台中市	Taichung
台北	Taipei
台湾	Taiwan
台盆	washbasin
臼	mortar
舀勺	scoop
舀子	ladle
与此同时	meanwhile
与众不同	distinctive
兴会	brainwave
举不胜举	innumerable
举措	move
举隅法	synecdoche
旧字体	kyujitai
旧爱	ex
舌	tongue
舒喘灵	albuterol
舒畅	happy
舛误	error
舞者	dancer
舞台	arena
舞蹈家	dancer
舟	boat
舟船	boat
舟车劳顿	travel-worn
舠	kayak
舢	sampan
舨	sampan
航图	chart
航天员	astronaut
航天器	spacecraft
航海者	navigator
航空	aviation
航空器	aircraft
航空术	aeronautics
航空邮件	airmail
航空邮简	aerogram
舭	bilge
舵手	helmsman
舶	ship
舸	barge
船坞	dock
船夫	boatman
船帆	sail
船桨	oar
船货	cargo
船运业	shipping
艉	aft
艑	skiff
舰	warship
舰船	warship
舰只	warship
艩	tholepin
艭	boat
良善	good
良师益友	mentor
良心	conscience
艰巨	challenging
色狼	lecher
色目	Semu
色素	pigment
艴	angry
艳红色	crimson
艾奥瓦	Iowa
艾奥瓦州	Iowa
艾略特	Eliot
芋艿	taro
芋螺毒素	conotoxin
芋头	taro
芝加哥	Chicago
芝士蛋糕	cheesecake
芝麻菜	rocket
芥	mustard
芫花素	genkwanin
芬兰	Finland
芭提雅	Pattaya
芭比	Barbie
芮	small
芯片	microchip
芯片组	chipset
花不棱登	gaudy
花冠	corolla
花匠	gardener
花商	florist
花岗岩	granite
花岗石	granite
花巧	fancy
花房	greenhouse
花朵	flower
花束	bouquet
花椰菜	cauliflower
花火	firework
花炮	firecracker
花石	marble
花粉	pollen
花花公主	playgirl
花花公子	playboy
花菜	cauliflower
花萼	sepal
花莲	Hualien
花艺	floriculture
花艺师	florist
花蜜	nectar
花蟒	python
花饺	dumpling
芳	fragrant
芳香疗法	aromatherapy
芽孢	endospore
苔	moss
苔原	tundra
苔藓	moss
苗	sprout
苗床	seedbed
苛刻	harsh
苛求	demanding
苜	clover
苞米	maize
若是	if
若有所思	thoughtfully
若无其事	nonchalant
若隐若现	indistinct
苦因	affliction
苦杏仁苷	amygdalin
苦胆	gallbladder
苦苣	endive
苦菊	endive
苦逼	wretched
苦难	suffering
苦头	sufferings
苯乙烯	Styrene
苯胺	aminobenzene
苯那辛	benactyzine
英俊	handsome
英伦	England
英伟达	NVIDIA
英国	Britain
英式	British-style
英式橄榄球	rugby
英格兰	England
英法	Anglo-French
英汉	English-Chinese
英特尔	Intel
英亩	acre
英华	English-Chinese
英雄好汉	heroes
英雄式	heroic
苲草	hornwort
茂盛	lush
茄	eggplant
茄克衫	jacket
茄红素	Lycopene
茇	betel
茉莉	jasmine
茉莉花	jasmine
茉莉菊酯	jasmolin
茍	urgent
茛	ranunculus
茜素	alizarin
茨欣瓦利	Tskhinvali
茬子	stubble
茯苓	tuckahoe
茵	mattress
茶匙	teaspoon
茶坊	teahouse
茶碗	teacup
茶碗蒸	chawanmushi
茶缸	mug
茶花	camellia
茶藨子	currant
茶碱	Theophylline
茸	downy
茸毛	fuzz
草丛	underbrush
草坪	lawn
草场	pastureland
草垫子	palliasse
草寇	bandits
草料	fodder
草甸	meadow
草蜢	grasshopper
草食	herbivorous
草饲	grass-fed
荆芥	schizonepeta
荑	grass
荒原	wasteland
荒唐无稽	preposterous
荒山野岭	wild
荒凉	desolate
荒淫	licentious
荒淫无耻	shameless
荒漠化	desertification
荒谬	absurd
荒野	wilderness
荔	litchi
荵	polemonium
荷	lotus
荷官	croupier
荷尼阿拉	Honiara
荷巴特	Hobart
荷花	lotus
荷荷巴	jojoba
荷兰	Holland
荷兰芹	parsley
荷马	Homer
荽	coriander
庄严	solemn
庄荷	croupier
莎草	coco-grass
莘莘	numerous
莞	district
莞	smile
莫吉托	Mojito
莫名	inexpressible
莫名其妙	bizarre
莫拉莱斯	Morales
莫斯科	Moscow
莫桑比克	Mozambique
莫洛尼	Moroni
莫罗尼	Moroni
莫须有	groundless
莽撞	rash
莽汉	boor
菁英	elite
菇蕈	mushroom
菊苣	chicory
菌	mushroom
菌群	microbiota
菌胶团	zoogloea
菌苗	vaccine
菌菇	mushroom
菌陈蒿	tarragon
菌类	fungus
菔	turnip
菜燕	agar-agar
菜脯	dried
菜肴	dish
菠	spinach
菠萝	pineapple
菠萝蜜	jackfruit
菢	hatch
菥蓂	pennycress
菧	stibene
菩提达摩	Bodhidharma
菪	henbane
华林	Hualinbu
华林部	Hualinbu
华氏	Fahrenheit
华沙	Warsaw
华盛顿州	Washington
华丽	gorgeous
菱形	rhombus
菱铁矿	siderite
菲亚特	Fiat
菲律宾人	Filipino
烟酰胺	nicotinamide
烟醯胺	niacinamide
烟碱	nicotine
烟碱醯胺	niacinamide
莱城	Lae
莱斯特郡	Leicestershire
莱比锡	Leipzig
莱索托	Lesotho
莱菔	radish
萍	duckweed
萎叶	betel
萎靡不振	downcast
萏	lotus
万事通	jack-of-all-trades
万事达	MasterCard
万亿	trillion
万分痛苦	excruciating
万应灵丹	panacea
万托林	ventolin
万有	universal
万有引力	gravity
万无一失	surefire
万用表	multimeter
万科	Vanke
万圣节前夜	Halloween
万艾可	Viagra
万花筒	kaleidoscope
万象	Vientiane
万那杜	Vanuatu
万里无云	cloudless
莴笋	celtuce
落寞	lonely
落拓不羁	uninhibited
落叶剂	defoliant
叶绿素	chlorophyll
叶绿体	chloroplast
叶轮机械	turbomachine
叶里温	Yerevan
葍	weeds
葑	turnip
著作权	copyright
著称于世	world-renowned
着处	everywhere
葛兰素史克	GlaxoSmithKline
葡式	Portuguese-style
葡萄	grape
葡萄干儿	raisin
葡萄园	vineyard
葡萄弹	grapeshot
葡萄柚	grapefruit
葡萄树	grapevine
葡萄牙	Portugal
葡萄球菌	staphylococcus
葫芦巴	fenugreek
葫芦丝	hulusi
葬式	funeral
葳	luxuriant
葵花	sunflower
荤粥	Xunyu
蒂森克虏伯	ThyssenKrupp
蒎	pinane
蒙古	Mongolia
蒙古人	Mongol
蒙古包	yurt
蒙古国	Mongolia
蒙大拿	Montana
蒙大拿州	Montana
蒙得维的亚	Montevideo
蒙特利尔	Montreal
蒙特娄	Montreal
蒙特维多	Montevideo
蒙特雷	Monterey
蒙罗维亚	Monrovia
蒟	betel
蒟蒻	konjac
蒢	hedysarum
蒸汽	steam
蒸汽压路机	steamroller
蒸粗麦粉	couscous
蒸锅	steamer
蒸腾作用	transpiration
蒹	reed
苍天	firmament
苍翠	verdant
苍莽	boundless
苍蝇拍	flyswatter
蒽	anthracene
蓁	abundant
盖世太保	Gestapo
盖亚那	Guyana
盖然性	probability
盖茨比	Gatsby
蓬勃	vigorous
蓬散	loose
蓬头散发	disheveled
蓬松	fluffy
莲	lotus
莲蓬头	showerhead
蔓菁	turnip
蔓越橘	cranberry
蔓越莓	cranberry
蔗糖素	sucralose
参	ginseng
蔙	herb
蔚蓝	azure
葱绿	verdant
葱头	onion
蔫耷耷	listless
蔫头耷脑	withered
蔬	vegetables
荫	shade
蔽身处	shelter
蔾	chenopodiaceae
蕉	banana
荞麦	buckwheat
芸苔子	rapeseed
蕖	lotus
蕗	leucacene
蕨类	bracken
荡妇	slut
荡荡	fluttering
芜繁	convoluted
芜菁	turnip
蕾	bud
薄弱	weak
薄烤饼	pancake
薇薇安	Vivien
薉	weedy
姜	ginger
姜饼	gingerbread
姜黄	turmeric
蔷薇花蕾	rosebud
荐椎	sacrum
萨丁尼亚岛	Sardinia
萨克拉门托	Sacramento
萨克逊	Saxon
萨博	Saab
萨拉戈萨	Zaragoza
萨拉曼卡	Salamanca
萨拉热窝	Sarajevo
萨摩	Satsuma
萨摩亚	Samoa
萨满教	Shamanism
萨尔	Saarland
萨尔布吕肯	Saarbrücken
萨尔茨堡	Salzburg
萨兰斯克	Saransk
萨赫蛋糕	Sachertorte
萨那	Sana'a
薪给	salary
薪资	salary
薸	duckweed
苔草	sedge
藄	fern
藇	beautiful
借此	thereby
借由	through
借由	through
借着	through
蓝图	blueprint
蓝宝石	sapphire
蓝牙	Bluetooth
蓝莓	blueberry
蓝金黄	blue
蓝靛	indigo
藏书票	bookplate
藏茴香果	caraway
藘	madder
藜麦	quinoa
艺术	art
藤条	rattan
药代动力学	pharmacokinetics
药典	pharmacopoeia
药剂师	pharmacist
药动学	pharmacokinetics
药商	druggist
药妆	cosmeceuticals
药妆店	drugstore
药师	pharmacist
药店	pharmacy
药方	prescription
药物代谢动力学	pharmacokinetics
药物学	pharmacology
药物学家	pharmacologist
药理	pharmacology
药理学	pharmacology
药膏	ointment
蔼	friendly
藻类	algae
芦笋	asparagus
芦荻	reeds
芦苇	reed
苏丹	Sudan
苏克雷	Sucre
苏利南	Suriname
苏台德地区	Sudetenland
苏姆盖特	Sumgayit
苏打饼干	saltine
苏格兰	Scotland
苏格兰女王玛丽	Mary
苏格兰帽	bonnet
苏瓦	Suva
苏里南	Suriname
苏金达	Sukinda
苏门答腊	Sumatra
苏黎世	Zurich
苹果手机	iPhone
苹果酒	cider
蘑	mushroom
藓苔	moss
兰科	Orchidaceae
兰蔻	Lancôme
兰辛	Lansing
兰开斯特	Lancaster
蘼	millet
萝	radish
虎皮鹦鹉	budgerigar
虎钳	vise
虎头蜂	hornet
虎鲸	orca
虐心	heartbreaking
虔敬	reverent
处女膜	hymen
处所	place
处理器	processor
虚假	false
虚妄	fabricated
虚荣	vanity
虚荣心	vanity
虚构小说	fiction
虚无	nothingness
虚无主义	nihilism
虚无缥缈	illusory
虚谎	false
号筒	bugle
虩	terrified
虱	louse
虷	worm
虸蚄	armyworm
虹	rainbow
虹吸管	siphon
虹桥	Hongqiao
蚊	mosquito
蚊子	mosquito
蚊虫	mosquito
蚌壳	clamshell
蚔	green-frog
蚜	aphis
蚡	mole
蚤	flea
蚱	grasshopper
蚱蜢	grasshopper
蚱虫	grasshopper
蚴	larva
蚺	boa
蚺蛇	boa
蚿	millipede
蛆	maggot
蛆虫	maggot
蛇毒素	venin
蛇蒿	tarragon
蛇蝎	treacherous
蛉	sandfly
蛋包	omelet
蛋包饭	omurice
蛋奶冻	custard
蛋奶酥	soufflé
蛋壳	eggshell
蛋白光	opalescence
蛋白石	opal
蛋白素	albumin
蛋白质	protein
蛋白酶	protease
蛋酒	eggnog
蛋黄酱	mayonnaise
蛌	cricket
蛐	cricket
蛔虫病	ascariasis
蛙人	frogman
蛙鞋	flippers
蛛网	cobweb
蛜	woodlouse
蛡	beehive
蛣	beetle
蛤蚌	clam
蛤蜊	clam
蛤蟆	frog
蛭石	vermiculite
蛾子	moth
蛾摩拉	Gomorrah
蜂巢	honeycomb
蜂房	honeycomb
蜂窝	honeycomb
蜂箱	beehive
蜂胶	propolis
蜂蜜	honey
蜂蜜酒	mead
蜂蜡	beeswax
蜂鸟	hummingbird
蜂鸣器	buzzer
蜃景	mirage
蜅	crab
蜇	jellyfish
蜈蚣	centipede
蜉蝣	mayfly
蜊	clam
蜑家	Tanka
蜘蛛	spider
蜘蛛侠	Spider-Man
蜘蛛类	arachnid
蜙蝑	katydid
蜚	gad-fly
蜚蠊	cockroach
蜚蠊科	Blattidae
蜜	honey
蜜月	honeymoon
蜜月假期	honeymoon
蜜糖	honey
蜜蜂房	beehive
蜜蜡	beeswax
蜜露	honeydew
蜢	grasshopper
蜥形纲	Sauropsida
蜥蜴	lizard
蜩	cicada
蜻蛉目	Odonata
蜻蜓	dragonfly
蜻蜓目	Odonata
蝗	locust
蝗虫	locust
蝙蝠侠	Batman
虾夷葱	chive
虾子	shrimp
虾滑	smooth
虱	louse
蝲蛄	crayfish
蝴蝶铰	hinge
蜗蜒	snail
蝽	bedbug
蛳	snail
融资	financing
蚂螂	dragonfly
蚂蟥	leech
蚂蚁	ant
萤光绿	chartreuse
螯	chela
螯肢	chelicera
螯虾	crayfish
螺刀	screwdriver
螺旋形	spiral
螺旋桨	propeller
螺旋测微器	micrometer
螺旋钳	wrench
螺杆	screw
螺桨	propeller
螺丝	screw
螺丝起子	screwdriver
螺丝钉	screw
螺线	spiral
螺钉	screw
蟆	toad
螨	mite
蟑螂	cockroach
蟒	python
蟓	silkworm
𫊸	insect
蟢	spider
蟥	horse-leech
蝉	cicada
蝉科	Cicadidae
蛲虫病	enterobiasis
虫媒病毒	arbovirus
虫胶	shellac
虫类	insects
蟷	mantis
蟹	crab
蟺	earthworm
蚁	ant
蚁丘	anthill
蟾蜍	toad
蝇子	housefly
蠋	caterpillar
蝎子	scorpion
蝾	salamander
蝾螈	salamander
蚝	oyster
蠕动前进	wriggle
蠕虫	worm
𧏖	pearl-oyster
蠛蠓	midge
蜡像	waxwork
蜡像馆	waxworks
蜡笔	crayon
蜡质	waxiness
蠡	calabash
蠢事	folly
蠢材	idiot
蠢笨	stupid
蠢话	nonsense
蛎	oyster
蚕	silkworm
蚕宝宝	silkworm
蚕农	sericulturist
蠼螋	earwig
血刃	bloodshed
血友病	hemophilia
血吸虫	schistosoma
血吸虫病	schistosomiasis
血尿	hematuria
血帮	Bloods
血栓形成	thrombosis
血栓病	thrombosis
血栓症	thrombosis
血汗工厂	sweatshop
血液透析	hemodialysis
血清张力素	serotonin
血清素	serotonin
血渍	bloodstain
血癌	leukemia
血管摄影	angiography
血管造影	angiography
血红蛋白	hemoglobin
血缘	bloodline
血缘关系	consanguinity
血肉	flesh
血肉模糊	gruesome
血肉横飞	carnage
血色素沉积症	hemochromatosis
血亏	anemia
血迹	bloodstain
血迹斑斑	bloodstained
衁	blood
行人径	footway
行凶者	perpetrator
行动主义	activism
行家	connoisseur
行政员	administrator
行星际	interplanetary
行会	guild
行栈	warehouse
行业	trade
行为主义	behaviorism
行车记录仪	dashcam
行道	path
行销	marketing
衎	pleased
术前	preoperative
术后	postoperative
街区	block
街景	streetscape
街段	block
街灯	streetlight
街头	street
街头艺人	busker
衙门	yamen
卫理公会	Methodists
卫生棉条	tampon
卫生球	mothball
卫衣	sweatshirt
冲浪者	surfer
衢	thoroughfare
衣兜	pocket
衣冠冢	cenotaph
衣原菌	Chlamydia
衣子	covering
衣帽间	cloakroom
衣扣	button
衣服缝边	hem
衣橱	wardrobe
衣甲	armor
衣着	clothes
衣袋	pocket
衣装	garment
表位	epitope
表土	topsoil
表带	watchband
表征	symbol
表现型	phenotype
表皮剥脱素	exotoxin
表观	apparent
表观遗传学	epigenetics
表语	predicative
表面上	outwardly
表面活化剂	surfactant
表面活性剂	surfactant
衰迈	aged
袋子	bag
袋鼠	kangaroo
袖口	cuff
袖子	sleeve
袖筒	sleeve
袖箍	armband
袖管	sleeve
被乘数	multiplicand
被加数	augend
被动	passive
被害人	victim
被物化	objectified
被译	translated
被面	quilt
裁判员	referee
裁判官	judge
裁定	ruling
裁缝师	tailor
裁军	disarmament
裂殖	schizo-
裂脑人	commissurotomy
裂隙	gap
裂体吸虫	schistosome
裒	collect
裕	abundant
裙裤	culottes
补偿费	compensation
补剂	tonic
补品	tonic
补炉	fettling
补给品	supplies
补花	applique
补药	tonic
补选	by-election
补遗	addendum
装佯	affectation
装饰品	ornament
里边	inside
里头	inside
裲	waistcoat
裸	naked
裸地化	denudation
裸露	naked
裸露狂	exhibitionism
裸体	naked
裸体主义	nudism
裸体主义者	nudist
制件	workpiece
制造业者	manufacturer
制造者	maker
制陶工人	potter
裾	garment
褂	gown
复印件	photocopy
复印机	photocopier
复本	copy
复杂	complicated
复杂性	complexity
褐色	brown
褥	mattress
褥疮	bedsore
裤腰带	waistband
裤衩	underpants
裤裙	culottes
亵昵	disrespectful
褽	collar
襚	grave-clothes
襟怀夷旷	broad-minded
裆部	crotch
褴褛	shabby
袜带	garter
衬垫	pad
衬裙	petticoat
衬里	lining
衬裤	underpants
衬页	endpaper
袭击者	attacker
西	west
西乃	Sinai
西伯利亚	Siberia
西北	northwest
西南	southwest
西坡拉	Zipporah
西城区	Xicheng
西拉雅族	Siraya
西敏	Westminster
西柚	grapefruit
西洋人	Westerner
西洋杉	cedar
西洋棋	chess
西洛赛宾	psilocybin
西班牙	Spain
西班牙港	Port-of-Spain
西米	sago
西红柿	tomato
西葫芦	zucchini
西兰花	broccoli
西西弗斯	Sisyphus
西西里岛	Sicily
西里西亚	Silesia
西雅图	Seattle
要不得	intolerable
覃	deep
覆灭	destruction
覆盆子	raspberry
覆盖物	mulch
覆盖率	coverage
覆盖面	coverage
见不得人	shameful
见习员	trainee
见背	formal
觃口	Yankou
规例	regulations
规则化	regularity
规则性	regularity
规划人员	planner
规律性	regular
规条	regulations
规模	scale
规程	rules
规章	rule
觅食行为	foraging
视	literary
视力	eyesight
视图	view
视差	parallax
视盲	blindness
视网膜	retina
视频	video
覗	peek
觋	wizard
亲善	goodwill
亲子丼	oyakodon
亲爱精诚	camaraderie
亲昵	intimate
亲水性	hydrophilic
亲王	prince
亲眷	relatives
亲缘	consanguinity
亲美	pro-U.S.
亲肤	skin-friendly
观世音	Guanyin
观世音菩萨	Guanyin
观光客	tourist
观客	audience
观察人士	observer
观察员	observer
观察者	observer
观测台	observatory
观测者	observer
观众	spectators
观音	Guanyin
观音菩萨	Guanyin
观鸟	birdwatching
角妓	courtesan
角朊	keratin
角膜	cornea
角质素	keratin
角锥	pyramid
角斗士	gladiator
角龙	ceratopsian
觖	dissatisfied
解剖刀	scalpel
解剖学	anatomy
解毒剂	antidote
解毒药	antidote
解码器	decoder
解药	antidote
解说员	commentator
解酸药	antacid
觯	goblet
触媒	catalyst
触媒作用	catalysis
触屏	touchscreen
触手	tentacle
触技曲	toccata
触控屏	touchscreen
触控屏幕	touchscreen
触控式萤幕	touchscreen
触摸屏	touchscreen
触摸屏幕	touchscreen
触毛	vibrissa
触肢	pedipalp
触处	everywhere
言下之意	implication
言情	romantic
言而无信	untrustworthy
订书针	staple
订购者	subscriber
讣告	obituary
讣闻	obituary
计分卡	scorecard
计数率仪	ratemeter
计数管	counter
计数者	counter
计时器	timer
计步器	pedometer
计程车	cab
计策	stratagem
计谋	stratagem
讯号	signal
讨人厌	horrid
讨喜	endearing
训练者	trainer
讪脸	impudent
讪讪	embarrassed
讫	finished
记帐员	bookkeeper
记法	notation
记录员	recorder
记录器	recorder
讶	astounded
讼	litigation
讼案	lawsuit
访问者	interviewer
访客	visitor
访华	formal
设或	if
设若	if
许字	betrothed
诉讼	lawsuit
诊所	clinic
注脚	footnote
诈骗罪	fraud
𫍡	cheat
评书	pingshu
评级	rating
评论员	commentator
评议会	council
评鉴	evaluation
𬣞	wisdom
词人墨客	wordsmith
词位	lexeme
词典学	lexicography
词尾	suffix
词素	morpheme
咏叹调	aria
询盘	inquiry
试剂	reagent
试探性	exploratory
试纸	chemistry
试金	assay
试验性	experimental
诗律	prosody
诗词	verse
诠释学	hermeneutics
诠释资料	metadata
话痨	chatterer
话语权	influence
该亚	Gaea
该应	should
详备	detailed
詹森	Johnson
认死扣儿	stubborn
认识不能	agnosia
诞辰	birthday
诱人	attractive
诱拐者	abductor
诱变剂	mutagen
诱饵	bait
语句	sentence
语境	context
语汇	vocabulary
语意性	semantic
语数外	Chinese
语料库	corpus
语法	grammar
语源	etymology
语用学	pragmatics
语素	morpheme
语义学	semantics
语言学	linguistics
语言学家	linguist
语音学	phonetics
诚信	honesty
诚实	honest
诚心	sincerity
诚意	sincerity
诫命	commandment
误区	misconceptions
诵读困难症	dyslexia
诲淫性	licentious
说不出话来	speechless
说服力	persuasiveness
说谎者	liar
课外	extracurricular
课室	classroom
谇	abuse
诽	slander
调光器	dimmer
调制	modulation
调制解调器	modem
调味肉汁	gravy
调查人员	investigator
调查员	investigator
调查者	investigator
调皮捣蛋	naughty
调节器	regulator
调羹	spoon
调色板	palette
调色盘	palette
调药刀	spatula
调酒师	bartender
调门	valve
谄媚者	flatterer
谈性色变	prudish
请坐	please
请愿书	petition
论法	argumentation
论理学	logic
论著	treatise
论题	topic
咨询员	advisor
诸凡百事	everything
诸柘	sugarcane
谚	proverb
谚文	hangul
谚语	proverb
诺亚	Noah
诺克少	Nouakchott
诺夫哥罗德	Novgorod
诺曼底	Normandy
诺曼第	Normandy
诺言	promise
诺鲁	Nauru
谋杀罪	murder
谋计	stratagem
谎言	lie
谎话	lie
谜	riddle
谜儿	riddle
谜样	enigmatic
谜面	riddle
𫍲	small
谧	peaceful
谦	modest
谦卑	humble
讲解员	guide
讲辞	lectures
谢忱	gratitude
谢尔巴人	Sherpa
谣传	rumor
谣言	rumor
证人	witness
证件	certificate
证券经纪人	stockbroker
证实礼	confirmation
证明书	certificate
证章	badge
证言	testimony
证词	testimony
𫍢	wrangling
谲	deceitful
识别码	identifier
识别号	identifier
识文断字	literate
谱学	spectroscopy
谱系	pedigree
警句	aphorism
警报器	siren
警官	constable
警察	police
警方	police
警笛	siren
警辟	profound
谵妄	delirium
译码器	decoder
议事日程	agenda
护士	nurse
护栏	guardrail
护理学	nursing
护理师	nurse
护目镜	goggles
护肤	skincare
护卫舰	frigate
护身符	amulet
读写能力	literacy
读书人	scholar
读法	pronunciation
读者	reader
变化无常	fickle
变压器	transformer
变奏	variation
变流器	converter
变现能力	liquidity
变异	variation
变装者	cross-dresser
变调夹	capo
变体	variant
谶	omen
谶语	prophecy
谷	valley
谷地	valley
谷歌	Google
豆瓣	Douban
豆瓣网	Douban
豆蔻年华	adolescence
豆豆帽	beanie
豆类	bean
竖琴	harp
丰厚	generous
丰台区	Fengtai
丰度	abundance
丰硕	plentiful
丰裕	well-off
象征主义	symbolism
象声词	onomatopoeia
象虫	weevil
豨	swine
豪宅	mansion
豪华	luxurious
豪言壮语	bold
豪猪	porcupine
猪倌	swineherd
猪场	piggery
猪栏	pigsty
猪油	lard
猪窠	pigsty
猪肉	pork
豻	jail
豻	canine
貆	badger
貌	looks
猫儿	kitten
猫咪	kitty
猫声鸟	catbird
猫腻	shenanigans
猫薄荷	catnip
猫雾族	Babuza
猫头鹰	owl
貘	tapir
貜	ape
贝塔斯曼	Bertelsmann
贝宁	Benin
贝拉	Beira
贝拉米	Bellamy
贝斯	Bes
贝氏体	bainitic
贝尔墨邦	Belmopan
贝尔格勒	Belgrade
贝尔格莱德	Belgrade
贝尔法斯特	Belfast
贝尔莫潘	Belmopan
贝纳通	Benetton
贝鲁特	Beirut
贞	chaste
贞洁	chastity
负担者	bearer
负累	burden
财务	finance
财务秘书	treasurer
财路	livelihood
财阀	tycoon
贡品	tribute
贡布	Kampot
贡物	tribute
贡赋	tribute
贫乳	flat-chested
贫穷潦倒	destitute
贫血	anemia
贫血症	anemia
货仓	warehouse
货品	goods
货币主义	monetarism
货栈	warehouse
货盘	pallet
货载	cargo
贩子	trafficker
贪吃	gluttonous
贪吃者	glutton
贪嘴	gluttonous
贪心	greedy
贪污腐败	corruption
贪腐	corruption
贪食	gluttonous
贯时	diachronic
贮水处	reservoir
贮物	storage
贵圈真乱	slang
贵妇人	dame
贵妇犬	poodle
贵族社会	aristocracy
贵宾犬	poodle
贵重	precious
买主	customer
买家	buyer
买办	comprador
费利克斯	Felix
费洛蒙	pheromone
费卢杰	Fallujah
贴纸	sticker
贻贝	mussel
贺拉斯	Horace
贲	energetic
贲	bright
资本主义	capitalism
资本家	capitalist
资禀	talent
资讯	information
资费	postal
资金	funds
贾第虫病	Giardiasis
宾利	Bentley
宾夕法尼亚	Pennsylvania
宾夕法尼亚州	Pennsylvania
宾得	Pentax
宾词	predicate
𫎩	gem
赏鸟	birdwatching
赔偿金	compensation
赓即	promptly
贤劳	diligent
贤明	sagacious
贤能	sage
卖主	seller
卖国主义	treason
卖国贼	traitor
卖家	seller
卖肉者	butcher
贱格	despicable
赋税	taxation
质粒	plasmid
账单	bill
账号	account
赌场	casino
赌客	gambler
赌徒	gambler
购物	shopping
购物券	coupon
购买者	purchaser
赛力斯	Seres
赛德克族	Seediq
赛德娜	Sedna
赛轮思	Cerence
赜	mysterious
赘肉	flab
赘余	superfluous
赠款	grant
赠礼	present
赠与者	giver
赞助商	sponsor
赞比亚	Zambia
赞西佩	Xanthippe
赞词	praise
赞辞	praise
赢家	winner
赃	loot
赎款	ransom
赎金	ransom
赝	false
赤睛鱼	rudd
赤脚	barefoot
赤藓糖醇	erythritol
赤藓醇	erythritol
赤贫	poverty-stricken
赤身	naked
赫耳墨斯	Hermes
赭	ocher
走扁带	slacklining
起初	originally
起劲	energetic
起司蛋糕	cheesecake
起士蛋糕	cheesecake
起床号	reveille
起落架	undercarriage
起诉员	prosecutor
起诉者	plaintiff
起重机	crane
超人	Superman
超前意识	foresight
超升	exaltation
超售	overbooking
超商	mini-mart
超媒体	hypermedia
超对称	supersymmetry
超导	superconductivity
超我	superego
超敏反应	hypersensitivity
超文件	hypertext
超文本	hypertext
超新星	supernova
超模	supermodel
超泛神论	panentheism
超然	aloof
超现实	surreal
超现实主义	surrealism
超短裙	miniskirt
超级名模	supermodel
超级市场	supermarket
超级强国	superpower
超级英雄	superhero
超级计算	supercomputing
超级计算机	supercomputer
超群绝伦	incomparable
超能力	superpower
超临界	supercritical
超自然	supernatural
超越主义	transcendentalism
超链接	hyperlink
超音速	supersonic
超频	overclocking
超验主义	transcendentalism
越南	Vietnam
越式	Vietnamese-style
赶快	quickly
赵国	Zhao
趣剧	farce
趋势	trend
足	excessive
足印	footprint
足够	enough
足踝	ankle
足高气强	arrogant
足高气扬	arrogant
趺	instep
趾	toe
趾尖	tiptoe
趾甲	toenail
趾高气扬	arrogant
趿拉儿	babouche
跂	foot
跂訾	opinionated
跅	careless
跋胡疐尾	idiom
跌打药	liniment
跑堂儿的	waiter
跑步者	runner
跑者	runner
跑表	stopwatch
跑马场	racecourse
跕	shuffle
跗猴	tarsier
跙	weak
跛足	lame
跟差	attendant
跟踪狂	stalker
迹线	trajectory
迹象	sign
跣	barefooted
跨境	cross-border
跨学科	interdisciplinary
跨性别	transgender
跨文化	intercultural
跨洲	intercontinental
跨省	interprovincial
跨领域	interdisciplinary
路旁	roadside
路易斯安那	Louisiana
路易斯安那州	Louisiana
路桩	bollard
路沙卡	Lusaka
路环	Coloane
路码表	odometer
路缘	curb
路边	curb
路面电车	streetcar
跳弹	ricochet
跳蚤	flea
局	cramped
跽	kneel
踆	squat
踊	leap
踏垫	doormat
踏板摩托车	scooter
踏板车	scooter
踏雪板	snowshoe
踝	ankle
踢拳	kickboxing
踦	shin
踩镲	hi-hat
踊	leap
蹂	trample
蹄印	hoofprint
蹇运	misfortune
蹊跷	odd
蹝	slippers
跖骨	metatarsus
蹢	hoof
踪	trace
蹦床	trampoline
蹬子	pedal
蹴鞠	cuju
跷跷板	see-saw
躁	impatient
躁狂	manic
趸	wholesale
趸批	wholesale
跃龙	allosaurus
身心爽快	refreshment
身心科	psychiatry
身心障碍	disability
身手敏捷	agile
身披羽毛	feathered
身躯	body
躲避球	dodgeball
车床	lathe
车库	garage
车胎	tire
车载	onboard
车辆	vehicle
车轮	wheel
车轮子	wheel
车驾	carriage
轨	track
轨距	gauge
军事化	militarization
军事法庭	court-martial
军国主义	militarism
军方	military
军旅	army
军火库	arsenal
军号	bugle
军需官	quartermaster
轫	brake
轭	yoke
软呢	soft
软文	advertorial
软木	cork
软毛	fur
软甲纲	Malacostraca
软骨	cartilage
软体动物	mollusk
𫐈	sacrifice
轴突	axon
轴距	wheelbase
輀	hearse
较好	better
载弹量	payload
载荷	load
载货汽车	truck
挽诗	elegy
辅修	minor
辅导人	tutor
辅音	consonant
轻信	gullible
轻慢	irreverent
轻手轻脚	quietly
轻染	tinge
轻柔	soft
轻狂	frivolous
轻轻	lightly
轻量	lightweight
轻食	snack
辉瑞	Pfizer
辊	roller
辈儿	generation
轮廓	outline
轮廓线	outline
轮椅	wheelchair
轮机手	helmsman
轮渡	ferry
轮状病毒	rotavirus
轮盘赌	roulette
轮箍	tire
轮胎	tire
轮毂罩	hubcap
轮转机	merry-go-round
輴	hearse
输尿管	ureter
辐射	radiation
辐射分解	radiolysis
辐射敏感性	radiosensitivity
辐射计	radiometer
辐照	irradiation
辒	hearse
辒车	hearse
毂盖	hubcap
辘	windlass
转动件	rotor
转喻	metonymy
转瞬即逝	transitory
转矩	torque
轑	spokes
轰击	bombard
辔	bridle
辔头	bridle
轳	windlass
辛伐他汀	simvastatin
辛劳	laborious
辛勤	hardworking
辛布	Thimphu
辛辛那提	Cincinnati
辣子鸡	laziji
辣根	horseradish
辣椒素	capsaicin
辣白菜	kimchi
办事处	office
办公室	office
办公桌轮用	hot-desking
辨士	penny
辨识度	distinctiveness
辞令	rhetoric
辞书学	lexicography
辞海	Cihai
辞藻	rhetoric
辩才	eloquence
辰砂	cinnabar
农人	farmer
农园	plantation
农地	farmland
农场	farm
农奴	serf
农家庭院	farmyard
农旅	agritourism
农业生技	agri-biotechnology
农民	peasant
农民阶级	peasantry
农舍	farmhouse
农艺	agronomy
迂气	pedantry
迂远	impractical
迅雷	thunderbolt
近乎同步	plesiochronous
近在眼前	imminent
近义词	near-synonym
近处	nearby
近亲交配	inbreeding
近亲繁殖	inbreeding
近路	shortcut
迕	obstinate
迢	remote
迥	distant
迦太基	Carthage
迪士尼乐园	Disneyland
迪拜	Dubai
迪斯科吧	discotheque
迫切	urgent
迫切性	urgency
迫在眉睫	imminent
述语	predicate
回力镖	boomerang
回旋处	rotary
回旋镖	boomerang
回旋余地	leeway
迷乱	confusion
迷你剧	miniseries
迷你裙	miniskirt
迷彩	camouflage
迷蒙	misty
迷踪罗汉拳	Mizongyi
迷阵	maze
迷离惝恍	confusing
迷离马虎	muddle-headed
追悼文	eulogy
追星族	stan
退伍军人	veteran
退关	shut-out
逃亡者	runaway
逆喻	oxymoron
逆戟鲸	orca
逆龄	anti-aging
透平机	turbine
透彻	penetrating
透明程度	transparency
透水性	permeability
透红	rosy
逐渐	gradually
逐行	progressive
途径	way
迳向	radial
迳流	runoff
迳赛	track
迳迹	track
逗人喜爱	cute
逗点	comma
这些	these
这些个	these
这儿	here
这里	here
通勤	commuting
通古斯	Tungus
通心粉	macaroni
通心面	macaroni
通情达理	sensible
通书	almanac
通气会	briefing
通用串行总线	USB
通用性	universality
通行税	toll
通货紧缩	deflation
通货膨胀	inflation
通透	penetrating
通途	thoroughfare
通量	flux
通关密语	password
通关文牒	passport
速射	rapid-fire
速度计	speedometer
速率	speed
速记	shorthand
速记员	stenographer
速递	courier
速录师	stenographer
造句	sentence-making
造型服装	costume
造林	forestation
造纸	papermaking
造船	shipbuilding
造船所	shipyard
连字符	hyphen
连字符号	hyphen
连忙	promptly
连招	combo
连指手套	mittens
连接器	connector
连接号	hyphen
连接词	conjunction
连接酶	ligase
连枷	flail
连歌	renga
连滚带爬	scrambling
连环	chain
连番	repeatedly
连结主义	connectionism
连绵不绝	unending
连续性	continuity
连续体	continuum
连翘	Forsythia
连词	conjunction
连体裤	jumpsuit
周一	Monday
周三	Wednesday
周二	Tuesday
周五	Friday
周六	Saturday
周四	Thursday
周天	Sunday
周日	Sunday
周末	weekend
进度表	schedule
进步主义	progressivism
进深	depth
进程	process
进阶	advanced
进项	income
逶迤	meandering
逸宕	dissolute
逸乐	pleasure-seeking
逸荡	dissolute
遇难船	shipwreck
游侠	knight-errant
游吟诗人	troubadour
游园会	carnival
游戏场	playground
游戏王	Yu-Gi-Oh!
游乐场	playground
游艺	entertainment
运动学	kinematics
运动服	sportswear
运动鞋	sneakers
运河	canal
运货员	porter
过劳	overwork
过多	excessive
过度医疗	overtreatment
过敏原	allergen
过于	excessively
过氧化	peroxide
过氧化物	peroxide
过当	excessive
过街天桥	skywalk
过载	overload
过量	excessive
过头话	exaggeration
遐终	forever
遑	leisure
道具服	costume
道卡斯族	Taokas
道奇	Dodge
道德家	Daoist
道拉吉里峰	Dhaulagiri
道牙	curb
道听途说	gossip
道馆	dojo
达喀尔	Dakar
达尼亚	Dania
达拉斯	Dallas
达尔富尔	Darfur
达尔文主义	Darwinism
达尔文学说	Darwinism
达尔马提亚	Dalmatia
违宪	unconstitutional
违禁品	contraband
违者	violator
遥	remote
遥测	telemetry
遥远	distant
递质	neurotransmitter
远地点	apogee
远端转移	metastasis
远识	foresight
远距离	long-distance
适意	agreeable
适当	suitable
适老化	elder-accessible
适配	adaptation
迟了	late
迟滞现象	hysteresis
迁居移民	immigration
选编	anthology
选举权	suffrage
选集	anthology
遗传学	genetics
遗传率	heritability
遗孀	widow
遗孤	orphan
遗尿	bed-wetting
遗忘症	amnesia
遗物	remnant
遗缺	vacancy
遗体告别式	funeral
辽	faraway
辽宁号	Liaoning
辽远	distant
辽阔	vast
避孕	contraception
避弹坑	foxhole
避役	chameleon
避蚊胺	DEET
迈巴赫	Maybach
邈冥冥	distant
邈然	distant
边境	frontier
边框	frame
邋遢	unkempt
逻	patrol
逻辑学	logic
逦	winding
那些	those
那儿	there
那古屋	Nagoya
那里	there
那里	there
邦	nation
邦联	confederation
邪僻	abnormal
邪荡	obscene
邪术	sorcery
邵族	Thao
郅隆	prosperous
郊区	outskirts
郊外	outskirts
郛	suburbs
郡治安官	sheriff
部件	part
部族	tribe
部落	tribe
部众	troops
邮差	postman
邮戳	postmark
邮袋	mailbag
邮费	postage
邮资	postage
邮递员	mailman
都市	city
都市美型男	metrosexual
都会美型男	metrosexual
都柏林	Dublin
乡下佬	villager
乡下习气	provincialism
乡情	homesickness
邓迪	Dundee
邻人	neighbor
邻右	neighbor
邻左	neighbor
酊剂	tincture
配偶	spouse
配子	gamete
配称	worthy
配送者	distributor
配镜人员	optician
配镜师	optician
配餐	catering
配体	ligand
酐	anhydride
酒刺	acne
酒席	feast
酒廊	bar
酒徒	drunkard
酒楼	restaurant
酒水	beverage
酒浆	wine
酒精饮料	liquor
酒花	hops
酒庄	winery
酒蒙子	alcoholic
酒钱	tip
酒鬼	drunkard
酗	drunk
酚	phenol
酚酞	phenolphthalein
酣	intoxicated
酥油	butter
酩酊大醉	plastered
酪乳	buttermilk
酪梨莎莎酱	guacamole
酪饼	cheesecake
酬偿	reward
酬劳	reward
酬赏	reward
酬载	payload
酮	ketone
酮糖	ketose
酯	ester
酯化	esterification
酯酶	esterase
酴	yeast
酵母菌	yeast
酵母醇	zymosterol
酵素	enzyme
酵解作用	zymolysis
酷刑	cruelty
酷炫	awesome
酸乳	yogurt
酸乳酪	yogurt
酸奶	yogurt
酸性	acidity
酸莓	cranberry
酸辛	misery
酸黄瓜	pickle
腌货	pickles
腌黄瓜	pickle
醉	intoxicated
醉意	tipsiness
醉鬼	drunkard
醋栗	gooseberry
醚	ether
醛	aldehyde
醛固酮	aldosterone
醛糖	aldose
丑事	scandal
丑国	USA
丑怪	grotesque
丑闻	scandal
丑行	scandal
丑陋	ugly
糖类	carbohydrate
医师	doctor
医患	doctor-patient
酱料	sauce
醯	acyl
酿母菌	yeast
酿造学	zymurgy
衅隙	enmity
酽	rich
采地	fief
采声	applause
采邑	fief
释名	"Shiming"
释教	Buddhism
里加	Riga
里弗赛德	Riverside
里斯本	Lisbon
里昂	Lyon
里朗威	Lilongwe
里瓦尔多	Rivaldo
里程碑	milestone
里程表	odometer
重力	gravity
重商主义	mercantilism
重器	treasure
重婚	bigamy
重婚罪	bigamy
重孙	great-grandson
重孙女	great-granddaughter
重孙子	great-grandson
重新	again
重新统一	reunification
重新装修	refurbishment
重新造林	reforestation
重碳酸盐	bicarbonate
重要	important
重要性	importance
重复性	repetitive
野兔	hare
野地	wilderness
野外定向	orienteering
野牛	bison
野狐禅	heresy
野禽	fowl
野蛮人	barbarian
量子	quantum
量计	gauge
量身定制	tailor-made
厘克	centigram
厘升	centiliter
厘米	centimeter
金光闪烁	spangle
金刚狼	Wolverine
金刚总持	Vajradhara
金刚萨埵	Vajrasattva
金刚鹦鹉	macaw
金匠	goldsmith
金合欢	acacia
金夏沙	Kinshasa
金子	gold
金库	treasury
金柑	kumquat
金桔	kumquat
金枪鱼	tuna
金沙萨	Kinshasa
金瓜石	Jinguashi
金石学	epigraphy
金秋	fall
金丝燕	Aerodramus
金丝雀	canary
金融家	financier
金酒	gin
金银块	bullion
金银花	honeysuckle
金钱豹	leopard
金钟	Admiralty
金鱼	goldfish
金黄	golden
金龟子	scarab
钌铞儿	hasp
钉书机	stapler
钉耙	rake
钉螺	Oncomelania
钉钉	DingTalk
钉钯	rake
针剂瓶	ampoule
针孔	pinhole
针扎	pincushion
针法	stitch
针状	needle-shaped
针箍	thimble
针管	syringe
针织品	knitwear
针叶树	conifer
钓客	angler
钓针	fishhook
钓钩	fishhook
钓鱼者	angler
钐刀	scythe
钐镰	scythe
扣	button
扣子	button
扣眼	buttonhole
钒钾铀矿石	carnotite
钗	hairpin
钮	button
钙质	calcium
钶	columbium
钹	cymbals
钿	money
钻	treasure
𬬿	sickle
鉏	hoe
铂金	platinum
铆钉	rivet
铅垂线	plumbline
铅管工	plumber
钺	battle-ax
钩子	hook
钩扣	hook
钩端螺旋体病	leptospirosis
钩头篙	boathook
𬬸	acmite
铰链	hinge
鉼	plate
银保	bancassurance
银匠	silversmith
银器	silverware
银屑病	psoriasis
银杏	ginkgo
银莲花	anemone
银行家	banker
银行业	banking
银行业务	banking
铜匠	coppersmith
铜绿	verdigris
铜绿层	patina
铜锈	verdigris
铜锈层	patina
铜锣	gong
铚	sickle
铭文	inscription
铭瑄	MaxSun
铵	ammonium
锐	acute
销势	sale
铝土矿	bauxite
鋆	gold
铤	ingot
铗子	tongs
铻	hoe
锄犁	plow
锃亮	shiny
锃光	shiny
铺位	bunk
铺板	bedboard
铺盖	bedding
铺盖卷儿	bedroll
锆合金	zircaloy
锯木厂	sawmill
锯末	sawdust
锯齿	sawtooth
钢	steel
钢弹	Gundam
钢枪	rifle
钢片琴	celesta
钢琴家	pianist
钢琴师	pianist
钢锯	hacksaw
钢铁	steel
锥形	conical
锥虫病	trypanosomiasis
锥面	cone
铮亮	shiny
钱钞	money
𫓹	hoe
锦缎	brocade
锦绣	beautiful
锚	anchor
锡克	Sikh
锡克教	Sikhism
锡安	Zion
锡拉库萨	Syracuse
锡瓦	Siwa
锡箔	tinfoil
锡纸	tinfoil
锡金	Sikkim
错愕	astonished
错处	fault
错杂	mixed
表带	watchband
锨	shovel
锅炉	boiler
镀银	silver-plated
鍏	spade
键帽	keycap
键盘	keyboard
键词	keyword
鎉	thallium
锁匠	locksmith
锁孔	keyhole
锁眼	keyhole
蓥	polish
铠	armor
铠甲	armor
镐头	pickaxe
镇区	township
镇痛药	analgesic
镇纸	paperweight
镇静剂	tranquilizer
镇静药	sedative
旋床	lathe
链子	chain
链结	linkage
链路	link
链轮	sprocket
鏊子	griddle
镆铘	Moye
铲土机	bulldozer
铲运机	carry-scraper
铲雪车	snowplow
镜片	lens
錾子	chisel
𬭸	phosphonium
𨱑	bell
𫔍	vanadium
钟乳	stalactite
钟乳石	stalactite
钟摆	pendulum
钟乐	bells
钟表盘	clockface
钟表	clock
镫	stirrup
镢	hoe
镢头	hoe
镰刀	sickle
镯	bracelet
铁三	triathlon
铁人	Ironman
铁人三项	triathlon
铁撬	crowbar
铁板烧	teppanyaki
铁琴	metallophone
铁砧	anvil
铁锈	rust
铁青	ashen
铁骨铮铮	unyielding
铁齿	argumentative
钥匙卡	keycard
钥匙链	keychain
镊子	tweezers
銮	imperial
凿子	chisel
凿死铆子	obstinate
钃	metal
长宽	size
长崎	Nagasaki
长度	length
长弓	longbow
长方形	rectangle
长方体	cuboid
长期性	long-term
长板	longboard
长柄勺子	ladle
长柄大镰刀	scythe
长柄镰刀	scythe
长条	strip
长棍	baguette
长椅	bench
长牙	tusk
长生不死	immortality
长篇小说	novel
长统袜	stockings
长老会	Presbyterianism
长号	trombone
长裤	trousers
长距离	long-distance
长钉	spike
长靴	boot
长颈瓶	flask
长颈龙	tanystropheus
门卡	keycard
门吸	doorstop
门垫	doormat
门外汉	layman
门岗	gate
门径	access
门徒	disciple
门挡	doorstop
门柱	doorpost
门牙	incisor
门碰	doorstop
门铃	doorbell
门限	doorsill
门头沟区	Mentougou
门齿	incisor
闪光	flash
闪光弹	flashbang
闪卡	flashcard
闪回	flashback
闪米特	Semitic
闪辉	scintillation
闪闪	flickering
闭会祈祷	benediction
闭经	amenorrhoea
闭着	closed
开创性	innovative
开山刀	machete
开山鼻祖	founder
开拓者	pioneer
开放性	openness
开水壶	kettle
开发人员	developer
开发者	developer
开罗	Cairo
开襟衫	cardigan
开路先锋	pioneer
开车族	motorists
开通	open-minded
闲暇	leisure
闲余	unoccupied
间作	interplanting
间接	indirect
间脑	diencephalon
间谍	spy
间谍软件	spyware
间距	gap
闸机	turnstile
阂	obstruct
闾尾	coccyx
阅读障碍	dyslexia
阍	doorkeeper
阈	threshold
阈值	threshold
阔度	breadth
阔绰	extravagant
关塔纳摩	Guantanamo
关塔那摩	Guantanamo
关岛	Guam
关东煮	oden
关税与贸易总协定	GATT
关节炎	arthritis
关贸总协定	GATT
关键字	keyword
关键词	keyword
阮	ruan
防伪	anti-counterfeiting
防冻	antifreeze
防守者	defender
防弹	bulletproof
防水	waterproof
防火墙	firewall
防火道	firebreak
防特	counterespionage
防磁	antimagnetic
防避	protection
防骇	anti-hacker
阻尼	damping
阿什哈巴德	Ashgabat
阿什哈巴特	Ashgabat
阿佛洛狄忒	Aphrodite
阿佤	Wa
阿修罗	Asura
阿伦	Aalen
阿克拉	Accra
阿利坎特	Alicante
阿加迪尔	Agadir
阿卡	Acre
阿卡普尔科	Acapulco
阿塞拜疆	Azerbaijan
阿多尼斯	Adonis
阿奶	granny
阿姆斯特丹	Amsterdam
阿宅	homebody
阿富汗	Afghanistan
阿布叔醇	albuterol
阿布哈兹	Abkhazia
阿布贾	Abuja
阿弥陀如来	Amitabha
阿得莱德	Adelaide
阿德莱德	Adelaide
阿拉	me
阿拉丁	Aladdin
阿拉巴马	Alabama
阿拉巴马州	Alabama
阿拉摩	Alamo
阿拉斯	Arras
阿拉斯加	Alaska
阿拉斯加州	Alaska
阿拉木图	Almaty
阿拖品化	atropinization
阿斯塔纳	Astana
阿斯马拉	Asmara
阿明	Al-Amin
阿曼	Oman
阿月浑子	pistachio
阿根廷	Argentina
阿森	Assen
阿比西尼亚	Abyssinia
阿洛菲	Alofi
阿尔卡特	Alcatel
阿尔及利亚	Algeria
阿尔及利亚人	Algerian
阿尔及尔	Algiers
阿尔巴尼亚	Albania
阿尔梅里亚	Almería
阿尔盖达	al-Qaeda
阿尔萨斯	Alsace
阿特兰蒂斯	Atlantis
阿瓦鲁阿	Avarua
阿皮亚	Apia
阿维拉	Avila
阿肯色	Arkansas
阿肯色州	Arkansas
阿芙蓉	opium
阿兹特克	Aztec
阿蒙	Amun
阿盖达	al-Qaeda
阿萨姆	Assam
阿兰文	Aramaic
阿西吧	aw
阿谁	who
阿里巴巴	Alibaba
阿閦佛	Aksobhya
阿非利加	Africa
阿鲁巴	Aruba
陀螺仪	gyroscope
附加物	complement
附加费	surcharge
附笔	postscript
附肢	appendage
附录	appendix
陌生	strange
陌生人	stranger
陌路人	stranger
陌陌	Momo
降肾上腺素	noradrenalin
降落伞	parachute
降血钙素	calcitonin
限制级	R-rated
陕南	Shannan
陕甘宁	Shaanxi
陡削	precipitous
陡峭	precipitous
陡度	gradient
院落	courtyard
阵风	gust
除垢剂	detergent
除沾染	decontamination
除湿器	dehumidifier
除湿机	dehumidifier
除臭剂	deodorant
陪奁	dowry
陪嫁	dowry
陪审员	juror
陪审团	jury
阴囊	scrotum
阴屁	queef
阴户	vulva
阴核	clitoris
阴沉	gloomy
阴凉	shady
阴沟	sewer
阴茎	penis
阴蒂	clitoris
阴道	vagina
阴道瓣	hymen
阴部	genitalia
阴霾	haze
陲	frontier
陈旧	old-fashioned
陈迹	vestiges
陴	parapet
陶匠	potter
陶器	pottery
陆基	land-based
陆战队	marines
陆栖	land-based
陆海空三军	army
陆海空军	army
陆军上校	colonel
陆军中尉	lieutenant
陆龟	tortoise
阳伞	parasol
阳光房	sunroom
阳光浴	sunbathing
阳具	penis
阳宗	sun
阳极	anode
阳沟	ditch
阳物	penis
阳道	penis
隅	corner
隆隆	rumble
陧	dangerous
队友	teammate
队形	formation
阶级式	hierarchical
隔板	divider
隔音	soundproofing
隘谷	ravine
隘路	defile
隙缝	aperture
障壁	barrier
障眼法	smokescreen
隞	Ao
隧洞	tunnel
隧道	tunnel
随同	accompanying
随员	attendant
随机应变	pragmatic
随笔	essay
随行人员	entourage
险滩	shoals
隐	hidden
隐修	monasticism
隐喻	metaphor
隐士	hermit
隐密	secret
隐写术	steganography
隐形	invisible
隐栖动物学	cryptozoology
隐睾	cryptorchidism
隐秘	secret
隐约	vague
隐袭	insidious
隐隐约约	faintly
隐隐绰绰	faint
隶圉	servants
只身	alone
雀巢	Nestlé
雀斑	freckles
雀鸟	bird
雂	bird
雄厚	substantial
雄性	male
雄辩家	orator
雄鸡	rooster
雄鹰	tercel
雅	elegant
雅典	Athens
雅典娜	Athena
雅利安	Aryan
雅加达	Jakarta
雅威	Yahweh
雅恩德	Yaounde
雅气	elegance
雅温得	Yaoundé
雅尔塔	Yalta
雅穆索戈	Yamoussoukro
雅罗鱼	dace
雅虎	Yahoo
雅马哈	Yamaha
集中器	concentrator
集市	market
集约	intensive
集萃	treasury
集镇	town
集韵	Jiyun
集体主义	collectivism
雇主	employer
雇员	employee
隽材	talent
雌三醇	estriol
雌性	female
雌性激素	estrogen
雌激素	estrogen
雌狮	lioness
雌蕊	pistil
雌雄同体	hermaphrodite
雌雄同体性	hermaphroditism
雌鹿	doe
雍	harmony
雍和	harmony
雍容大度	generous
雍正	Yongzheng
雍重	cumbersome
雕刻品	sculpture
雕刻家	sculptor
双乳	breasts
双元音	diphthong
双光气	diphosgene
双唑泰栓	metronidazole
双城子	Shuangchengzi
双峰	boobies
双拐	crutches
双曲线	hyperbola
双极	bipolar
双氢睾酮	dihydrotestosterone
双氯醇胺	clenbuterol
双球菌	diplococcus
双稳	bistable
双筒望远镜	binoculars
双管	double-barreled
双节棍	nunchaku
双糖	disaccharide
双翼飞机	biplane
双肩包	backpack
双规	shuanggui
双语	bilingual
双轨	double-track
双边	bilateral
双重	double
双陆棋	backgammon
双双	both
双音节	bisyllable
双体船	catamaran
雏型	model
雏形产品	prototype
雏菊	daisy
杂技演员	acrobat
杂文	essay
杂草	weeds
杂讯	interference
杂货商	grocer
杂质	impurity
杂音	noise
杂项	miscellaneous
杂食动物	omnivore
鸡公	cock
鸡奸	sodomy
鸡枞	macrolepiota
鸡蛋壳儿	eggshell
离奇	odd
离子	ion
离岸	offshore
离心分离机	centrifuge
离心机	centrifuge
离散性	discreteness
离谱	inappropriate
难以置信	incredible
难伺候	high-maintenance
难吃	unpalatable
难忘	unforgettable
难民	refugee
难为情	embarrassed
难处	trouble
难点	difficulty
雨具	rainwear
雨凇	verglas
雨搭	awning
雨林	rainforest
雨棚	awning
雨水	rainwater
雨滴	raindrop
雨泽下注	rainfall
雨量	rainfall
雨点	raindrop
雪佛莱	Chevrolet
雪佛兰	Chevrolet
雪地车	snowmobile
雪城	Syracuse
雪套	gaiters
雪崩	avalanche
雪岳山	Seoraksan
雪景	snowscape
雪梨	Sydney
雪片	snowflake
雪球	snowball
雪种	refrigerant
雪花	snowflake
雪茄烟	cigar
雪貂	ferret
云吞	wonton
云杉	spruce
云母	mica
云气	mist
云沙	muscovite
云液	muscovite
云烟	mist
云珠	muscovite
云石	marble
云英	muscovite
云华	muscovite
云贵川	Yunnan
云头	cloud
零散	scattered
零部件	component
零食	snack
零点五	0.5
雷克雅未克	Reykjavik
雷克雅维克	Reykjavik
雷恩	Rennes
雷暴	thunderstorm
雷朗	Luilang
雷朗族	Luilang
雷声	thunder
雷阵雨	thundershower
雷雨	thunderstorm
雹	hail
雹块	hailstone
雹暴	hailstorm
电位器	potentiometer
电位计	potentiometer
电信	telecommunications
电冰柜	freezer
电化学	electrochemistry
电匠	electrician
电报机	telegraph
电压	voltage
电压表	voltmeter
电压计	voltmeter
电子人	cyborg
电子商务	e-commerce
电子学	electronics
电子空间	cyberspace
电容	capacitance
电容器	capacitor
电影剧本	screenplay
电影制作	filmmaking
电影制片	filmmaking
电感	inductance
电扶梯	escalator
电抗	reactance
电极	electrode
电气化	electrification
电气石	tourmaline
电泳	electrophoresis
电流表	ammeter
电瓶	accumulator
电疗	electrotherapy
电眼	beautiful
电磁	electromagnetic
电磁学	electromagnetism
电磁铁	electromagnet
电筒	flashlight
电臀舞	twerking
电解质	electrolyte
电负性	electronegativity
电阻器	resistor
电离层	ionosphere
电震	electroshock
霅	rain
震波图	seismogram
震耳	ear-splitting
震耳欲聋	deafening
霉菌	mold
霉菌毒素	mycotoxin
霍乱	cholera
霍地	suddenly
霍尼亚拉	Honiara
霍巴特	Hobart
霍尔木兹	Hormuz
霍顿	Hotton
霜条	popsicle
霜白	frosty
霡霂	drizzle
雾件	vaporware
雾化器	nebulizer
雾化机	nebulizer
雾蒙蒙	foggy
雾茫茫	foggy
雾霭	mist
霰弹枪	shotgun
霰粒肿	chalazion
露珠	dewdrop
露肩	shoulder-baring
露背	halterneck
露西	Lucy
露体	naked
霸权主义	hegemonism
霹雷	thunderbolt
霹雳舞	breakdancing
霾	haze
灵妙	wonderful
灵活性	flexibility
灵车	hearse
灵骨塔	columbarium
灵体	soul
灵魂伴侣	soulmate
叆叆	misty
靐	thunder
青光眼	glaucoma
青年期	adolescence
青春痘	acne
青春豆	acne
青睐	favor
青紫	purple
青肿	bruise
青花椰菜	broccoli
青花菜	broccoli
青草	grass
青釉	celadon
青靛	indigo
青霉素	penicillin
靛花	indigo
靛青	indigo
静力学	statics
静心	meditation
静恬	tranquil
静脉	vein
静谧	calm
非人化	dehumanization
非公式	unofficial
非利士地	Philistia
非动物性	inanimacy
非同步	asynchronous
非均质	inhomogeneous
非官方	unofficial
非写实	nonrepresentational
非对称	asymmetric
非小说	non-fiction
非层状	unstratified
非峰值	off-peak
非必需	inessential
非政府	non-governmental
非数字	non-numeric
非暴力	nonviolent
非核	non-nuclear
非核化	denuclearization
非正式	unofficial
非法	illegal
非独立	dependent
非直接	indirect
非规整	irregular
非递推	nonrecursive
非遗传多型性	polyphenism
非零	nonzero
非预谋	unpremeditated
非高峰	off-peak
非党	non-party
靠不住	unreliable
靠得住	reliable
靡烂	rotting
面具	mask
面向连接	connection-oriented
面孔	face
面无人色	ashen-faced
面疱	acne
面纱	veil
面纸	kleenex
面色	complexion
面试官	interviewer
面颊	cheek
面颜	face
面庞	face
腼腆	shy
靥	dimple
革命性	revolutionary
靴	boots
靴子	boots
靶子	target
鞅鞅	dissatisfied
鞋套	overshoe
鞋子	shoe
鞋履	footwear
鞋拔	shoehorn
鞋拔子	shoehorn
鞍子	saddle
鞍马劳顿	travel-worn
鞘	scabbard
鞘脂	sphingolipid
鞙	fine
鞞	scabbard
鞣质	tannin
鞣酸	tannin
鞭毛	flagellum
鞭毛纲	flagellate
鞭节	flagellum
鞭虫	whipworm
鞹	leather
缰绳	reins
韦伯	Webb
韦尔瓦	Huelva
韦科	Waco
韦驮菩萨	Skanda
韧劲	tenacity
韧带	ligament
韧性	toughness
韧皮	phloem
韧皮部	phloem
韧体	firmware
韨	kneepad
韩国泡菜	kimchi
韩国街	Koreatown
韩式	Korean-style
韩式泡菜	kimchi
韖	tan
韫	contain
韡	gorgeous
韭	leek
音位	phoneme
音信	message
音乐剧	theater
音乐学	musicology
音乐家	musician
音节	syllable
音系学	phonology
音素	phoneme
音耗	message
韶	glorious
响亮	resounding
响尾蛇	rattlesnake
响声	noise
响音	sonorant
頀	music
页	head
页岩	shale
页蒿	caraway
顶呱呱	excellent
顶端	summit
顶级	top-notch
顶针	thimble
頄	cheekbone
项圈	necklace
顺利	smoothly
顺化	Hue
顺性别	cisgender
顺时针	clockwise
顺滑	smooth
顺当	smoothly
顺磁	paramagnetic
顺义区	Shunyi
顸	dawdling
须要	must
顼顼	frustrated
颂歌	carol
颀	tall
预先	beforehand
预报	forecast
预定义	predefined
预后	prognosis
预应力	prestressed
预收费	prepayment
预算	budget
预言家	prophet
预试	pretest
顽固	stubborn
顽梗	obstinate
顽皮	naughty
顽童	urchin
顿时	immediately
顿涅茨克	Donetsk
顿首	kowtow
頖	disperse
领主	suzerain
领事	consul
领事馆	consulate
领土	territory
领域	domain
领导人	leader
领导者	leader
领航员	navigator
领袖	leader
领诺	consent
领头羊	bellwether
颏	chin
头倒立	headstand
头儿	leader
头儿脑儿	bigwig
头向前	headlong
头寸	position
头戴式耳机	headphones
头晕	dizzy
头晕目眩	dazzled
头朝下	headfirst
头枕	headrest
头梳	comb
头疼	headache
头皮	scalp
头皮屑	dandruff
头盔	helmet
头箍	headband
头羊	bellwether
头胸部	cephalothorax
头脑风暴	brainstorming
头足纲	Cephalopoda
头部	head
头铁	headstrong
头骨	skull
颊	cheeks
颈	neck
颈子	neck
颈背	nape
颈部	neck
颈链	necklace
颈项	neck
频仍	frequent
频度	frequency
频数	frequency
频数	repeated
频次	frequency
频率	frequency
题外话	digression
额头	forehead
颚部	jaw
颜值高	good-looking
颜厚	brazen
顑	yellow
颠狂	demented
颠连	illogical
类人猿	hominid
类似	similar
类似点	resemblance
类固醇	steroid
类属词典	thesaurus
类星体	quasar
类毒素	toxoid
类目	category
类语辞典	thesaurus
类鼻疽	melioidosis
颟	dawdling
𫖹	frown
显微学	microscopy
显明	obvious
显然	clearly
显目	eye-catching
显示器	monitor
颅测量	craniometry
风姿绰约	lovely
风情万种	charming
风挡	windshield
风景	scenery
风格	style
风流倜傥	debonair
风泼	crazy
风湿	rheumatism
风笛	bagpipes
风筝冲浪	kitesurfing
风箱	bellows
风习	custom
风华	magnificent
风评	reputation
风速计	anemometer
风险	risk
飑	whirlwind
台	typhoon
台风	typhoon
飓风	hurricane
飘渺	indistinct
飞地	enclave
飞机云	contrail
飞瀑	waterfall
飞盘	frisbee
飞禽	birds
飞秒	femtosecond
飞腿	kick
飞膜	patagium
飞艇	airship
飞蛾	moth
飞行云	contrail
飞轮海	Fahrenheit
飞鸟	bird
飞鹰	eagle
食人俗	cannibalism
食人魔	ogre
食人鱼	piranha
食具	tableware
食尸鬼	ghoul
食欲	appetite
食料	foodstuff
食槽	manger
食水	Singapore
食肉	carnivorous
食肉动物	carnivore
食肉目	Carnivora
食腐动物	scavenger
食草动物	herbivore
食虫目	Insectivora
饭菜	food
饭食	food
饮品	beverage
饮食疗养	diet
饲养者	feeder
饱和	saturated
饼屋	bakery
餇	food
养分	nutrient
养老金	pension
养鱼池	fishpond
餐具	tableware
餐前酒	aperitif
餐宴	banquet
餐后酒	digestif
餐牌	menu
餐食	meal
余下	remaining
余存	remainder
余烬	ember
馃	cake
馅	filling
馅料	filling
餩	hiccup
餮	gluttonous
餲	sour
喂母乳	breastfeeding
馐	delicacies
饐	rancid
饶有兴趣	engrossing
饕	gluttonous
饕客	gourmand
馋痨	gluttony
馋鬼	glutton
馕	naan
馕坑	tandoor
馕饼	naan
首创者	pioneer
首字母缩写	acronym
首秀	debut
首领	head
香吻	kiss
香巴拉	Shambhala
香橼	grapefruit
香氛	fragrance
香港众志	Demosistō
香滑	creamy
香熏	aroma
香荽	coriander
香薰	aromatherapy
香酥	crisp-fried
香体剂	deodorant
馝	fragrance
馡	fragrant
馨	fragrant
马但	Matthan
马来亚	Malaya
马来西亚	Malaysia
马克思主义	Marxism
马克思列宁主义	Marxism-Leninism
马其顿	Macedonia
马具	harness
马列主义	Marxism-Leninism
马列毛	Marx
马力	horsepower
马匹	horse
马可尼	Marconi
马圈	stable
马国	Malaysia
马塞卢	Maseru
马尼拉	Manila
马尾辫	ponytail
马屁精	sycophant
马布多	Maputo
马厩	stable
马德望	Battambang
马德里	Madrid
马戏	circus
马戏团	circus
马拉博	Malabo
马拉维	Malawi
马拉开波	Maracaibo
马拿瓜	Managua
马斯喀特	Muscat
马斯特里赫特	Maastricht
马普托	Maputo
马朱罗	Majuro
马槽	manger
马槟榔	caper
马氏体	martensitic
马球	polo
马穆楚	Mamoudzou
马粪纸	strawboard
马约特	Mayotte
马纳马	Manama
马累	Malé
马耳他	Malta
马萨诸塞	Massachusetts
马萨诸塞州	Massachusetts
马蜂	hornet
马表	stopwatch
马褡子	saddle-bag
马趴	face-plant
马路牙子	curb
马蹄铁	horseshoe
马达加斯加	Madagascar
马达加斯加岛	Madagascar
马那瓜	Managua
马里	Mali
马里博尔	Maribor
马里兰	Maryland
马里兰州	Maryland
马铃薯	potato
马镫	stirrup
马陆	millipede
马面	Horse-Face
马鞍	saddle
马鞭	horsewhip
马骡	mule
马鳖	leech
马龙派	Maronites
驰名	famous
驯鹿	reindeer
馵	horse
驳船	barge
驳杂	heterogeneous
𫘝𫘨	hinny
𬳶	sturdy
駋	horse
驹	colt
𬳵	horse
驾帆船	sailing
驾驶人	car
驾驶员	pilot
驾驶室	wheelhouse
驼子	hunchback
駬	horse
骆马	llama
駽	gray
𫘧	horse
騋	mare
骒马	mare
骑兵	cavalry
骑士气概	chivalry
骑士风格	knighthood
騢	horse
腾格里	Tengri
腾讯	Tencent
骚然	turbulent
骚货	slut
骚驴	jackass
骚闹	noisy
蓦地	suddenly
蓦地里	suddenly
驱动器	drive
驒	horse
骄气	arrogance
验光师	optometrist
验光法	optometry
验尸官	coroner
验电器	electroscope
𫘰	horse
惊人	astonishing
惊呆	stupefied
惊心动魄	hair-raising
惊惶	panic-stricken
惊愕	stupefied
惊异	amazed
惊疑	bewildered
惊痫	epilepsy
惊险	perilous
骤雨	shower
驴骡	hinny
骨	bone
骨子里	fundamentally
骨感	bony
骨灰龛	columbarium
骨片	spicule
骨牌	dominoes
骨病	osteopathy
骨瘦如柴	emaciated
骨盆	pelvis
骨立	bony
骨坛	urn
骨质疏松	osteoporosis
骨质疏松症	osteoporosis
骨关节炎	osteoarthritis
骭	shinbone
骰	dice
骰子	dice
髁	condyles
脏字	obscenity
脏辫	dreadlocks
脏脏	dirty
体位	posture
体势	feature
体团	community
体弱	debility
体性	disposition
体操运动员	gymnast
体育场馆	gymnasium
体育运动	sports
体貌	appearance
体魄	physique
体鸣乐器	idiophone
高光时刻	highlight
高利贷	usury
高危	high-risk
高大	tall
高技术	high-tech
高斯	gauss
高明	brilliant
高深	profound
高卢	Gaul
高矗	towering
高祖母	great-great-grandmother
高祖父	great-great-grandfather
高端	high-end
高聚物	polymer
高腔	gaoqiang
高脚杯	goblet
高脚椅	stool
高通公司	Qualcomm
高速公路	expressway
高远	lofty
高铁血红蛋白	methemoglobin
高雄	Kaohsiung
高靿	high
高音喇叭	tweeter
高龄	elderly
髣	seemingly
髭	mustache
发型	hairstyle
发型设计师	hairstylist
发屋	barbershop
发带	headband
发箍	headband
发簪	hairpin
发网	hairnet
发蜡	pomade
发辫	braid
鬃毛	mane
鬅	disheveled
松泛	relaxed
须后水	aftershave
鬣毛	mane
鬣狗	hyena
鬣蜥	iguana
斗批改	struggle
斗拳	boxing
斗牛	bullfighting
斗鸡眼	cross-eye
闹区	downtown
闹热	lively
闹鬼	haunted
郁塞	pent-up
郁金香	tulip
郁郁寡欢	cheerless
郁郁葱葱	lush
鬼鬼祟祟	secretive
鬼魂	ghost
鬼魅	demon
鬼魔	demon
魂	soul
魂魄	soul
魅力四射	glamorous
魆魆	secretly
魏玛	Weimar
魑魅	demons
魔像	golem
魔王撒旦	Satan
魔术	magic
魔术师	magician
魔术贴	velcro
魔都	Modu
魔头	monster
魔鬼	devil
鱼刺	fishbone
鱼叉	harpoon
鱼塘	fishpond
鱼子酱	caviar
鱼尾	fishtail
鱼池	fishpond
鱼浆	surimi
鱼狗	kingfisher
鱼种	fingerling
鱼糜	surimi
鱼贩	fishmonger
鱼钩	fishhook
鱼雷	torpedo
鱼类	fishes
鱼类学	ichthyology
鱼饼	fishcake
鱼香	yuxiang
鱼鳍	fin
鱼龙	ichthyosaur
魣	perch
魣鱼	perch
鲁凯族	Rukai
鲁棒性	robustness
鲁莽	hot-headed
𫚍	shrimp
鱿鱼	squid
魸	catfish
魾	Bagarius
𫚖	fish
鲌	culter
鲉	scorpionfish
鲍	abalone
鲍鱼	abalone
鲒	oyster
𩽾𩾌	anglerfish
鲖	snakefish
鲜味	umami
鲜橙多	Xianchengduo
鲜美	tasty
鲜血	blood
鲜艳	bright-colored
鲤	carp
鲤鱼	carp
鲤鱼旗	koinobori
鲨	shark
鲨鱼	shark
鲻	mullet
鲯鳅	mahi-mahi
鲭	mackerel
鲭鱼	mackerel
鲷鱼烧	taiyaki
鲴	Xenocypris
鲱鱼	herring
鲸	whale
鲸豚	cetacean
鲶鱼	catfish
鳀	anchovy
鳀鱼	anchovy
鯸	blowfish
鳊	bream
鲗	cuttlefish
鲽鲛	sturgeon
鳇	sturgeon
𫚢	mudfish
鳏	widower
鳏夫	bachelor
鳍	fin
鳍状肢	flipper
鳁	sardine
鳌抃	overjoyed
鳘	cod
鲣	bonito
鳗鱼	eel
𫚧	herring
𫠒	octopus
鳕鱼	cod
鳟鱼	trout
鳝鱼	eel
鲟鱼	sturgeon
鱥	minnow
𫚭	minnow
鳄	crocodile
鳄梨酱	guacamole
鳄龙	Champsosaurus
鲡	eel
鸟儿	bird
鸟嘴	beak
鸟屋	birdhouse
鸟澡盆	birdbath
鸟疫	ornithosis
鸟禽	bird
鸟笼	birdcage
鸟羽	pinion
鸟脚下目	Ornithopoda
鸟雀	bird
鸟类	birds
鸠鸽	dove
鸤	turtledove
凤	phoenix
凤凰	phoenix
凤凰号	Phoenix
凤尾鱼	anchovy
凤梨	pineapple
凤梨释迦	atemoya
凤眼	elegant
鸣禽	songbird
鸣鸟	songbird
鸣鸠	turtledove
鸢尾	Iricdaceae
𫛞	shrike
鸦	crow
鸵	ostrich
鸵鸟	ostrich
鸱鸮	owl
鸭嘴兽	platypus
鸸鹋	emu
𫛩	quail
鸻	plover
䴕	woodpecker
鸽	pigeon
鵀	hoopoe
鹃	cuckoo
鹃形目	Cuculiformes
鹆	mynah
鹁	woodpidgeon
鹁鸽	pigeon
鵗	pheasant
鹈鹕	pelican
鹅膏蕈素	amanitin
鹅莓	gooseberry
鹄	swan
𫛳	owl
鹌鹑	quail
𫛱	pheasant
鹊	magpie
鶂	hawk
𫛷	pelican
鹜	duck
𬸣	soaring
鹤	crane
鹤嘴锄	pickax
鶸	siskin
鹡鸰	wagtail
鹘鸼	turtledove
鷇	fledglings
鹧鸪	partridge
鸶	heron
鹔鹴	green
鹫	vulture
鹫鸟	vulture
鹰嘴豆泥	hummus
鹰架	scaffolding
鹰头狮	griffin
鹭	heron
鹭鸶	egret
鸬鹚	cormorant
鹦鹉	parrot
卤质	alkalinity
碱	alkali
碱度	alkalinity
碱性	alkaline
盐度	salinity
盐田	saltpan
盐卤	brine
鹿	deer
鹿儿岛	Kagoshima
鹿特丹	Rotterdam
鹿肉	venison
麂	muntjac
麇	thronging
麑	fawn
麒麟菜	eucheuma
丽	Korea
丽	beautiful
丽实	practical
丽魄	moon
麝香	musk
麝香草	thyme
麦加	Mecca
麦卡锡主义	McCarthyism
麦地那	Medina
麦德林	Medellín
麦纳玛	Manama
麦纳麦	Manama
麦肯锡	McKinsey
麦芽	malt
麦芽糊精	maltodextrin
麦芽糖醇	maltitol
麦角	ergot
麸	bran
麸质	gluten
麮	porridge
麰	barley
面包屑	breadcrumbs
面包师傅	baker
面包渣	breadcrumbs
面包皮	crust
面包糠	breadcrumbs
面团	dough
面条	noodles
面筋	gluten
面粉	flour
面线	misua
面饼	flatbread
面体	noodles
面点	pastry
麻子	pockmark
麻布	sackcloth
麻溜	briskly
麻疹	measles
麻糬	mochi
麻药	anesthetic
麻醉学	anesthesiology
麻醉学者	anaesthesiologist
麻醉师	anaesthetist
麻醉药	anesthetic
麻醉药品	narcotic
麻黄素	ephedrine
麻黄碱	ephedrine
黄包车	rickshaw
黄原酸盐	xanthate
黄嘌呤	xanthine
黄曲霉毒素	aflatoxin
黄浦区	Huangpu
黄澄澄	golden
黄玉	topaz
黄疸	jaundice
黄疸病	jaundice
黄绿	yellow-green
黄姜	turmeric
黄蜂	wasp
黄蜡	beeswax
黄豆	soybean
黄酮	flavone
黄铁矿	pyrite
黄饼	yellowcake
黄体酮	progesterone
黄龙病	huanglongbing
黉	school
黎巴嫩	Lebanon
黎庶	populace
黎明	dawn
黏住	cling
黏合剂	glue
黏土	clay
黏液	mucus
黏滞	viscous
黏滞性	viscosity
黏痰	phlegm
黏稠度	viscosity
黏糊糊	sticky
黏胶液	viscose
黐	birdlime
黐胶	birdlime
黑信	blackmail
黑加仑	blackcurrant
黑名单	blacklist
黑塞哥维那	Herzegovina
黑夜	night
黑天	night
黑子	detractor
黑尿症	alkaponuria
黑手党	mafia
黑斑蚊	Aedes
黑沉沉	pitch-dark
黑洞洞	pitch-dark
黑漆麻花	pitch-dark
黑煤玉	jet
黑痣	mole
黑瘤	melanoma
黑管	clarinet
黑线鳕	haddock
黑胶	vinyl
黑色	black
黑茶藨子	blackcurrant
黑莓子	blackberry
黑轮	oden
黑醋栗	blackcurrant
黑魖魖	pitch-black
黓	black
黕	red
黗	yellowish-black
默剧	pantomime
默默无闻	unrenowned
点字	braille
点头招呼	beckon
党八股	drab
党羽	henchmen
黯	dim
黯然神伤	dispirited
黹	embroidery
黾	toad
鼎盛期	heyday
鼓吹者	advocate
鼓手	drummer
鼓板	clapper-board
鼓膜	eardrum
鼓鼓的	bulging
鼠	mouse
鼠海豚	porpoise
鼠疫	plague
鼠目寸光	short-sighted
鼠肚鸡肠	small-minded
鼠胆	cowardly
鼠蹊	groin
鼬鼠	weasel
鼹	mole
鼹鼠皮	moleskin
鼻	nose
鼻出血	nosebleed
鼻屎	booger
鼻息	breath
鼻涕	snivel
鼻渊	nasosinusitis
鼻炎	rhinitis
鼻烟盒	snuffbox
鼻疽	glanders
鼻窦炎	sinusitis
齇	rosacea
齐一	uniform
齐活	finished
齿轮箱	gearbox
齿颚矫正学	orthodontics
齿龈炎	gingivitis
齿龈音	alveolar
龅牙	bucktooth
龈炎	gingivitis
龈脓肿	gumboil
𱌶𱌹	buckteeth
龋齿性	caries-inducing
龙嵩	tarragon
龙嵩叶	tarragon
龙涎香	ambergris
龙舌兰酒	tequila
龙蒿	tarragon
龙虾	lobster
庞大	huge
庞然大物	colossus
庞贝	Pompeii
庞杂	complex
龛	shrine
龗	dragon
龟公	pimp
龟毛	fussy
龟甲万	Kikkoman
𰻝𰻝面	broad
